##################################### ###########################################
#   #     #         #       #       # #         #       #     #   #   #   #     #
# # # ### # ####### # ##### # # ### # # # ##### # ##### # ### # # # # # # # ### #
# # # #   # #     # #     # # # #     # # #   # # #     # #   # #   # # # # #   #
# # # # # # # ### # # ### # # # # ##### # # # # # # ##### # # # ##### # # # # ###
#   #   #   #     #   #   # #   # #   #   # # #     #     # # # #     #     #   #
# ##### ### # ##### ### # # ##### # # ##### # ### ### ##### # # # ############# #
#     #     #     #   # # #         #   #   #   #     #     # # #               #
##### ######### # ### # # ############# # # ### ####### ##### # # ###############
#     #         #     # # #       #   # # #     #     #       #   #   #         #
# ##### ##### ######### # # ##### # # # # ##### # ### ####### # ### # # ####### #
#       #   #       #   # # #   #   #   # #   # #       #     # #   #   #       #
# ####### # ####### # ### # # # ##### ### # # # ####### # ##### # ####### # #####
# #   #   #   #   # # #     # #       #   # # #           #     #   #     # #   #
# # # # # ### # # # # # ##### ######### # # # # ########### ####### # ##### # # #
# # # # #   #   #   # # #   #           # #   # #           #     # #       # # #
# # # # ### # ####### # # # ####### ### # # ### # # # ####### # # # ######### # #
#   # # #   #   #   # #   # #   #   #   #   #     # # #       # # #       #   # #
##### # # ##### # # # ##### # # # ### ####### # ### # # ####### # ####### # # # #
#     # # #   # # # # #     # # # #   #     # # #   # #       #   #     #   # # #
# ##### # # # # # # # # ### # # # # # # # # # # # ### # ##### ##### ### ##### # #
# #   #     # #   #   #     #   #   # # # # # # # #     #     #     #   #     # #
# # # ####### # ############# ##### # # # # # # # # ##### ##### ##### # # ### # #
#   # #       # #     #             #     # # # # # #     #     #     # #     # #
##### # ####### # ### # ##### ############# # # # # # ##### ### # # ### ####### #
#     # #       # #   # #   #               # #   #   #   # #   # # #           #
# ##### # ####### # ### # # ######### ####### ######### # # # ### # # # #########
# #   # # #       # #   # #           #   #   #         # # # #   # # # #       #
# # # # # # ##### # # ### ####### ##### # # # # ######### # # # ### # # # ##### #
#   # # #   #   # # #         #   #     #   #             # #   #   # #   #     #
##### # ##### # # # ##### ### # ### ##### ################# ##### ### # ### #####
#     #       # #   #   # #   #           #       #       # #     #   # #   #   #
# ############# ##### # # # ############### # ### # ##### # # # ### ### # # # # #
#     #   #     #     # #                   #     #     #   # # #   #   # # # # #
##### # # # # ### ##### ####### ##### ### ####### # ### ##### # # # # ### # # # #
#   #   #   #   # #     #     # #   # #   #     # # #   #     #   #   #   # # # #
# # ##### ##### # # # ### # # # # # # # ### ### # # # ### ### # ##### # # # # # #
# # #     #   # #   # #   # #   # #   #   #     #   # #     # # #     # # # # # #
# # # ##### # # # ### # # # ##### ####### ### ### ### # # # # # # ##### # # # # #
#     #     # #   #   # # #     #       #     #   #   # # # #   #       # #   # #
####### ### # # ### ### # ##### # ##### ##### # ### ### # # # ##### ### # ##### #
#   #   #   # #   #     # #   # #       #     #     #     # #     #     #     # #
# # # ### ### ### ####### # # # ######### ########### # ### ##### ########### # #
# # #   #   # #         #   #     #         #     #   #         # #       #   # #
# # # # # # # # ####### ######### # # ##### # ### # ########### # # ### # # ### #
#   # # # # # # #     # #         # #     #       # #   #       #     # # #     #
# ### # # # # # # ### # # ####### # ### # ####### # # # # ########### # # #######
#     # #   #     #   #   #     # # #   # #     # # # #   #       #     #       #
##### # ########### ####### ### # # # # # # ### # # # ##### ##### # ########### #
#   # # #       #   #     # #   #   # # # # #   # #   #           # #         # #
# # # # # ##### # ### ### # # # ##### # # # # ### ##### ######### # # # # ### # #
# # #   #     # # #   #     # # #   # # #   #   #       #         # # # # #     #
# # ######### # # # ### ##### # # # # # ####### ### ##### # ####### # # # # #####
# #       #   #   # #   #     #   # # # #     #   # #   # # #   #   #   # #     #
# # ##### # # ##### # ### ######### # # # ### ### # # # # # # # # # ##### ##### #
# #         #       #               #   #         #   #   #   #   #             #
# ###############################################################################

