####################### #########################################################
#   #     #   #           #                       #   #   #         #   #   #   #
# # # ### # # # ### ### # # # ################### # # # # # ##### # # # # # # # #
# #   #     # # #   #   # # # #         #       # # #   # # #     # # # # # # # #
# ##### ##### # # ### ### # # # ####### # # ### # # ### # # # ##### # # # # # # #
#   #   #     #         # # # # #       # #   #     #   # #   #     #   # # #   #
### # ### # ########### # # # # # ### ### ### ####### ### ##### ##### ### # # ###
#     #   # #   #       #   #   #   # #     #   #         #     #   # #   # #   #
# ##### ### # # # ### ######### ### # # ### ### # ######### # ### # # # ### ### #
# #   #       # # #   #     #   #     # #   #   # #         # #   # # #         #
# # # # ####### # # ### ### # ### # ### # ### ### # ######### # ### # # #########
#   # #       #   #     #     #   # #   #   #   # # #     #   #   # #       #   #
### # ####### ########### ##### # # # ##### ### # # # ### # ##### # ####### # # #
#   #     #         #     #   # # # #     # #   # #   #   #       #     #   # # #
# # # ### # ####### # # ### # # # # ##### # # # # ### # ############### # # # # #
# # # #   # #     #   # #   #   # #       # # # #   # # #     #         # #   # #
# # # # ### # ### ##### # ##### # ####### # # # ### # # # # # # ### ### # ##### #
# # # # #   #     #     #   #   # #     # # #   #   # # # # #   #   #   # #     #
# # # # # ####### # # ##### # ### # # # # # ### # ### # # # ##### ### ### # #####
#   # # # #     #   # #   #     #   # #   #     #     # #             #   # #   #
##### # # # ### ##### # # ##### ##### ############# ### ### ######### # ### # # #
#   # # #     # #   #   #     #     #   #         # #     #         # #   #   # #
# # # # ### # # # # ######### ##### ### # # ##### # # ### ### ##### # ### ##### #
# #     #   # #   # #         #   #   #   #     # # # #       #   # #           #
# # ##### ### ##### # ####### # # ### ######### # # # # # ##### # # #############
#   #   #   #     #           # #       #         #   # #     # #         #     #
##### # ### # ### ### ######### ####### # # ####### ### ##### # ######### # ### #
#     # #   #       #         #   #     # # #     # #       # # #       # # #   #
# ##### # ####### # ######### ### # ### # # # ### # # ##### # # # ##### # # # # #
# #     # #     # #         #   #       # #   #   # #     # # # #     # # #   # #
# # # ### # ### # ### ### # ### ######### ##### ### ##### # # # ##### # # ##### #
#   # #   #   #     # #   # #             #     #           # #       # #   #   #
##### # ##### ##### # # ### # ##### ####### ### # # ######### ####### # ### # ###
#     # #           # #       #   # #     #   # # # #   #           # #     #   #
# ##### # ####### ### ######### # # # ### ### # # # # # # ####### # # # ####### #
#       # #     # #           # # #   #     #     #   # #         #   # #   #   #
######### # ### # # ######### # # # ### ### ########### ############### # # # # #
#   #   # #     #   #     #   # # #   # #       #     #           #   #   # # # #
# # # # # ##### ##### ### # # # # ### # # ##### # ### ########### # # ##### # # #
# #   # #     #       #   # #   #   # # # #     #   # #       #   # # #     #   #
# ##### # ### # ####### ### ####### # # # # ##### # # # # ### # ### # # ### ### #
#   #   #   # # #       #   #         # # #       # #   # #   # #   #     #   # #
### # # ### # # # ####### ### ##### ### # ##### ### # ### # ### # # ### # ### # #
#   # # #   # #   #     #         #   # # #   #     #     # #   # #   # # #   # #
# # # # # # # # ### ### ######### ### # # # # ##### ##### # # ### ### # # # ### #
# # # #   # # # #     # #         #   # # # #     # #   # # # #   #   # #       #
# # # ##### # # # ### # # # ##### # ### # # # ### # # # # # # # ### ### ####### #
# #       #     # #   # # #     # # #   #   #     #   # # # # # #               #
# ####### ####### # ### # ##### # # # ################# # # # # # # #############
# #               # #   #     # #   # #   #     #       # # # # # # #           #
# # ############### # ### ### # ##### # # # ### # ####### # # # # # # ######### #
#   #       #       #     #     #       #       # #   #   # #   # #   #         #
# ### # ### # ##### ####### ##### ######### ##### # # # ### ##### ##### #########
# #   #   #   #   #       # #     #   #   #       # # #       #   #   # #       #
# # # ### # ### # ####### # # # ### # # # ######### # ##### # # ### # # # # ### #
#   #     #     #           # #     #   #           #       #       #     #     #
############################# ###################################################

