############# ###################################################################
#   #   #   #             #               #     #   #     #                     #
# # # # # # ######### ### # # ####### ### # ### # # # ### # ### ##### ##### ### #
# #   #   # #       # #   # # #     #   #       # # #     #     #   # #   #     #
# ### ### # # ### # # # # # # # ### ### ### ##### # ### ######### # # # # #######
#   #   # #       # # # # #   #           # #     #   # #     #   # #   # #     #
### ### # ### ##### # # # ######### ### # # # ##### # # # ### # ### ##### # ### #
#     #     #       #   #         #   # # # # #     #   #     # #   #     #     #
# # # ### # ##################### ### # # # # # # ########### # # ### ######### #
# # #   # #   #                     # #   #   # # #   #     #   # #   #       # #
# # # # # # # # ########### ####### # # ####### # # # # ### ##### # ### ##### # #
#     #   # # #   #       #     #     # #     #   # # # #         # #   #     # #
### ### ### # # # # ##### ##### # # ### # ### ##### # # # # ##### # # ### ### # #
#   #   #   # # # #       #   #   # #   #     #     #   # #     # #   #   #   # #
# ### ### # # # # ####### # # # ### # # # ##### ######### ### # # ##### ### ### #
# #   #   # # # # #     # # #   #   # # # #   #             # # #       #   #   #
# # # # # # # # # # ### # # ##### ### # # # # ########### # # # ####### # ### # #
# # # # #   # # # #   # # #       #   # #   #   #   #   # # #           # #   # #
# # # # ##### # # ### # # ######### ### # ##### # # # # # # ### ######### # ### #
# #   #     # # #   # # #           #   # #     # #   #   #   #         #       #
# ##### ### # # # # # # ####### ##### ### # ### # ########### ######### ####### #
#     # #   #   # # # # #   #   #     #   #     # #     #   #   #       #       #
##### # # # ##### # # # # # # ### # ### ######### # ### # # ### # ####### # #####
#   #     # #     #   #   # # #   #     #   #     # #   # #   # #   #     # #   #
# # ####### # ############# # # # ####### # # # ### # ### # # # # # # # ### # # #
# # #   #   #     #   #       # # #     # #   # #   # #     #     #   #     # # #
# # # # # ####### # # # ####### # # ### # ##### # # # # # ##### ############# # #
#   # #   #     # # # # #       # # #   #         # # # #     #     #   #   # # #
# ### ##### # # # # # # # ####### # # ############# # # ##### ##### # # # # # # #
# #   #     # # #   # #   #       # #   #   #   #   #     #     #     # # # # # #
# # ### ##### # ##### ##### ### ### ### # # # # # # ##### # ### # ##### # # # # #
#             #     # #   #   # #   #   # # # #   # #     #   # #       #     # #
### ############### # # # ### # # ### ### # # ### # # ####### # ############### #
#     #     #       # # #     # #     #   # #   #   #         #             #   #
# ### # ### # # ### # # ####### # ##### ### # # ### ############### ####### # # #
# #   # #   # #   # #           # #   #     # #   # #             # #   #   # # #
# # ### # ### ### # ####### ##### # # ### ### ### # # ##### ### # # # # # ### # #
# # #   # #   #   # #     #       # # #   #         #     #     # # # #   #   # #
# # # # # # ### ### # ### ##### ### # # ### ######### ### ####### # # ##### ### #
#   # # #   #   #     #   #     #   # #   #           #   #     #   # #     #   #
##### # ### # ### ##### # # ##### ### ### # ########### ### ### # ### # # ### ###
#     #     # #   #     # # #     #   #     #       #   #   #   #     # # #     #
# ##### ##### # # # ### # # # ### # ### ##### # ### # # # # # ######### # # ### #
#     # #   # # #     # #   # #   #     #     # #   # #   # # #     #     # #   #
# ### # # # # # ### # # ##### # ##### ### ### # # ### ### # # # ### # ##### # # #
# #   #   #   #     # #   #   # #   # #       #   #   #   #   # #   #   #   # # #
# # ################# ### # # # # # # # ########### # # ####### # ### # # # # # #
# # #                   #   # #   #   # #     #   # # # #   #   #     # # # # # #
# # # ##### ########### # ### ######### # ### # # # # # # # # ######### # # # # #
#     #   # #       #   # #   #   #     # #   # # # # #   # # #     #   #     # #
####### # # # # ### # # # # # # # # # ### # ### # # # ### # # # ### # ######### #
#       # #   # #   # #     #   # # # #   # #   #   #   # #   #     # #   #     #
# ##### # ##### # ### ######### # # # # ### # ####### # # ######### # # # # # ###
# #   #         # #   #         # # #   #   # #       #   #       #   # # # #   #
# # # ########### # # # # ####### # ##### # # # # ####### # ### # ##### # # ### #
#   #               #   #         #       #     #         #     #       #   #   #
############################################################################# ###

