######################################### #######################################
#         #     #     #     #   #   #   #     #           #           #         #
# ####### # # # # ### # ### # # # # # # ##### # # ### ### # ##### ### # ##### # #
#     #   # # # #     # #   # # # #   #     #   #   #       #   # #     #   # # #
##### # ### # # ### ### # ### # # # ####### ##### # ######### # # # # ### # # # #
#   #     #   #     #     #   # # # #             # #       # # #   #     #   # #
# # ##### ##### ##### ##### # # # # # ######### ### # ##### # # ######### ##### #
# #     # #   # #   # #     # # #   #         #       #   #   #         #       #
# ### # # # # # # # # # ##### # ### ### ##### ##### ### # ### ######### #########
# #   # #   #     # # # #   # #   #   #             #   #   #       #   #       #
# # ### ########### # # # # # ### ### ####### ####### ### # ### ### # ### ##### #
# # #               #   # #     #   #   #   #             # #   #   # #   #   # #
# # # ######### ######### ##### ### ### # # ##### ### ##### # ### ### # ### # # #
# # #         #     #     #       #   #   # #     #   #     #     #   #     #   #
# # ######### ### # # ##### ##### ### # ### # # ### ### ######### # ### #########
# #   #         # # # #   #           #   #   #   # #   #       # #     #       #
# ### # # ##### # # # # # # ############# ####### # # # # # ### # # ##### ##### #
#     # # #   #   # #   # #           #   #     # # # # # #     #   #     #     #
####### # # # ##### # ### ##### # ### # ### ### # # # # # ##### ##### ##### #####
#     # # # #     # # #         #     # #   #   #     #   #   #   #   #     #   #
# ### # # # ##### # # # ##### ######### # # # ##### ####### # ### # # # ##### # #
# #   # #   #     # # # #   # #     #   # # # #   # #     # #   #   # # #     # #
# # ### ##### ##### # # # # # # ### # ### # # # # # # ### # ### # ### # # ##### #
# # #   #     #   # # #   # # # #   #     #   # # # #     # #   #     #   #   # #
# # # # # ##### # # # ##### # # # ##### # # ### # # ##### # # ####### ##### # # #
# #   # #       # # # #     # #   #   # # # #   # # #   # # #   #     #     #   #
# ##### ######### # # # ##### # ### # # # # # ### # # # # # ### # ##### # #######
# #             # #   # #   # # #   #   # # # #   #   #     #   #       #       #
# # ########### # ##### # # # # # ##### # # # # ############# ############### # #
#   #       #   #   #   # #   #   #     # # #   #   #       # #   #   #       # #
### # # ### # ##### # ### # ### ### ##### # ### # # # # ### # # # # # # ####### #
#   # # #     #     # #   # #   #   #   # # #   # # # #   # # # # # #   #   #   #
# ### # # # ### ##### # ### # ### ### # # # # ### # # ### # # # # # ### # # # # #
# #   #   #           # #   # #   #   # #   #       # #   # # #       #   #   # #
# # # # ############### # # # # ### ### # ##### ##### # ### # ##### # ####### # #
# # # # #     #         # # #     #     # #   # #     # #   #       #   #     # #
# # # # # ### # ######### # ##### # ##### # # # # ##### # ### ######### # ##### #
# # #   # #   # #   #     # #   # #       # # # # #   # #   # #   #   #   #     #
# # ### # # # # # # # ##### # # # # ### ### # # # # # # # # # # # # # # ### # ###
# #     #   # #   #   #     # #   #     #   # # #   # # # #   # #   #   #   #   #
# ########### ######### ##### ########### # # # ##### # # # ### ######### ##### #
# #     #   #           #   # #       #   #   #         # #       #       #     #
# # ### # # ####### ### # # # # # ### # # ############### ####### # ##### # ### #
# # #     # #     #   # # #   # #     # # #   #                     #   # #     #
# # # # ### # ### ### # # ##### ####### # # # # ### ################# # # #######
#     # #   #         #       #         # # # #   #         #   #     # #       #
####### # ### ### ########### ######### # # # ### ####### # # # # ##### ####### #
#     # #   # #   #           #   #   # #   #       #     #   #       #   #   # #
# ### # # # # # # # ########### # # # # # # ####### # # ### ##### ### # # # # # #
# #     # # # # # #         #   #   # #   # #   #   # #     #   # #   # # # #   #
# # # ### # # # # ######### # # # ### ##### # # # ### ### ### # # # ### # # #####
#   # #   # # # # #     #     # # #   #       #   #     #     #   #     # #     #
# ### # ### # # # # ### # # ### # # # # ######### # ### ##### ######### # ##### #
# #   #       #   # #   # #     # # #   #       # #     #   # #         # #     #
# # # ############# # ### ####### # ##### # ### # ####### # # # ######### # ### #
#   #               #             #       #     #         #     #         #     #
################################################################# ###############

