######################################### #######################################
#           #                         #   #       #     #           #   #       #
# ######### # ####################### # # # # ### # ### # # ####### # # # # ### #
# #     #   #       #         #   #   # #   # #   # #     # #   #   # #   # #   #
# # # # # ### ##### # ####### # # # # # ##### # ### # ##### # # # # # ##### # # #
#   # #     # #   #       #     #   #     #   #   # #       # # # # #     # # # #
# ### ##### # # # ####### # ############# # # # # # # ####### # # # # ### # # # #
#         # #   # #       #   #         #   # # # # #   #     #   # #   # #   # #
######### # # ### # ######### # ####### ##### # # # ### # ######### ### # ##### #
#   #     #   #     #         #         #     # # # #   #     #   #   # # #     #
# # # # ### ### ##### ######### ######### ##### # # # # ##### # # ### # # # #####
# # # # #   #   #                         #   # # # # # #       #   #   #   #   #
# # # # # ### ### ####### ######### ####### # # # # # # # ### ##### ####### # # #
#       #   # #           #   #     #   #   #     # #   #   # #     #     #   # #
##### ### # # # ####### ### # # ##### # # ######### # ### # # # # ### # # ##### #
#   # #   #   # #     #     # # #   # #     #   #   # #   # # # #     # #       #
# # # # ####### # ### ##### # # # # # ### # # # # # # # ### # # ##### # ####### #
# #   #     #   #         # #   # #     # #   #   # #   #   # #     # # #     # #
# ######### # ####### ### # ##### ### # # ##### ### # ### ### ##### # # # ### # #
# #       # #       # #   # #     #   #   #   #     #     #   #     # # # #   # #
# # # ### # ####### # # ### # ##### ##### # # ############# ### ##### # # # # # #
#   # #   # #       #       # #   # #     # #     #   #   #   # #     #   # # # #
##### # # # # ######### ##### # # # # ### # # ### # # # # ### # # ### ##### # # #
#     # # # #         #     #   #   #     #   #   # #   #     #   #   #   #   # #
# ##### # # # ####### ##### ############### ### # # ### ########### ### # ### # #
#     # #   #                       #   #   #   # # #   #     #         #   # # #
##### # ########################### # # # ### ### # # # # ### # ### ####### # # #
#   #     #       #   #       #   #   # #     #     # #   #   #   # #   #   # # #
# # ##### # ##### # # # # ### # # ### # ### ### ##### ##### ##### # # # # # # # #
# # #     # #   #   #   # #   # #     # #   #       #       #   #     # # # #   #
# # # ##### # # # ####### # # # # ##### # ### ##### ####### # # ##### # # # #####
#   # #     # # # #     #   # # #     # #   # #     #   #   # #     #   #       #
# ### # ##### # # # ### ##### # ### # # ### # # ### # # # # # # ### ########### #
#     # #     #   #           #   # # #       #   #   # # # # # #   #       #   #
##### # # # ####### ######### # # # # ######### # ### # # # # # # # # ### # # # #
#     # # # #     #     #   #   # #   #     #   #   # # # # # # # # # #   #   # #
# ### # # # # ### ##### # # ##### ##### ### # ### # # # # # # # # # # # ##### # #
# #   #     # #   #   # # #       #   #     # #   # # # #   #     #     #     # #
# # ######### # # # # # # ### ##### # # ### # # ### # # ################# ##### #
#   #     #   # # # # # #   # #     # #   #   # #   # #   #   #         #   #   #
##### ### # ### # # # # # # # # ##### ### ### # # ### ### # # # ##### # ### # ###
#   #   #   #   #   # #   # #   #     #   #   #   #     # # #   #   # # #   #   #
# # ### ### # # ##### # ### ##### # ### # # ##### # # # # # # ### # # # # # ### #
# # #     # # #     #   #   #   # # #   # # #   #   # # # # # #   #   #   #   # #
# # # # # # # ##### ##### ### # # # # # # # # # ##### # # # # # ####### ##### # #
#   # # #   #       #     #   #   # # #   #   #         # # #   #     # #   # # #
### # # # ##### ### # ### # ####### # ### ##### ######### # # ### ### # # # # # #
#   # # #       #   # #   #       # #   # #     #   #     # #     #   #   # #   #
# ### # ######### ### # ######### # ### # # ##### # # ##### ##### # ##### # #####
#     # #   #     #   #           #   # #   #     #   #   #     #   #   # # #   #
# ##### # # # ### # ################# # ##### ######### # ##### ### # # # # # # #
# #       # #     # #   #           # #   #   #   #     #   #   #   # # # # # # #
# # ####### ####### # # # # ####### # ### # ### # # ####### # ### ### # # # # # #
#   #           #   # # # # #   #     #     #   # # #       #   # #     # # #   #
# ### # ####### # ### # # # # # # # ### # ### # # # # ######### # # # ### # ### #
#     #         #     #   #   #   #     #     #   #             #   #     #     #
######################### #######################################################

