##################################################################### ###########
#     #         #         #   #   #   #       #   #                       #     #
# ### # ##### # # ### ### # # # # # # # ### # # # # ##### ############### # ### #
#     #       # #   # #   # # # # # # #   # #   # # #   #   #   #           #   #
##### # ####### ### # # ### # # # # # ### # ##### # # # ### # # # ####### ### ###
#   # # #   #     # #   #   #     #         #   #   # # #   # # #       #   #   #
# # # # # # # ### # ##### ################### # ##### # # # # # ### ### ### ### #
# #   #   #     # #                 #     #   # #       # # # #   # #     # #   #
# # # ######### # ################# # ### # # # # ####### # # # # # # ### # # # #
#   # #         #   #             # #   #   #   #       #   #   #   #       # # #
##### # ########### # ########### # ### ########### ### ##################### # #
#     # #     #   #   #   #     # #   #           #     #         #         # # #
# # ### # ### # # ##### # # ### # ### ########### ##### # ####### # # ##### # # #
# # #   #   #   # #     # #   # # #   #   #     # #     #     #     # #       # #
# # # # ### ##### # ##### ### # # # ### # # ### # # # ####### # ##### # ####### #
# #   #   #     #   #   #       # #     #       # # #   #     # #     # #     # #
# ####### # ### ##### # ######### # ########### # # ### # ##### # ##### # # # # #
# #   #     #   #     #   #       # #     #   # # #     #       #   #   # # # # #
# # # # # ### ### ##### # # ####### # # # # # # # ##### # ####### # # ### # # # #
#   # # # #   #         #   #     #   # #   #     #     # #     # # # #   #   # #
# ### # # # # # # ### ### ### ### # ### # ######### ##### # ### # # # # # # ### #
# #   # # # # # #   #     #     # # #   # #             #       # # #   # # #   #
# # # # # # # # ### ####### ### # # # ### # # ######### ### ##### # ##### # # ###
# # # # #   # #   # #       #   #   # #     # #   #   #   #       #     #   #   #
# # # # ##### ### # # ####### ####### # ##### # # # # ### ####### # ### ####### #
# #   # #   # #   # # #   #   #     #   #     # #   # #           # #       #   #
# ##### # # # # # # # # # # ### # # ##### ##### ##### # ####### ### # # ### # ###
#   #   # # # # # # # # # # #   # #       #     #     # #   #   #   # # #   #   #
### # # # # # # # # # # # # # ### ######### ### # ##### # # # ### ### # # ##### #
#   # #   # #   #   # #     # #       #   #     # #   # # # # #   #   #       # #
# # # ##### ##### ### ####### # ##### # # ####### # # # # # # # ### ######### # #
# # #       #     #   #       # #   #   # #   #   # # # #   #   #   #     #     #
# # ######### ##### # # ##### # # # ##### # # # ### # # # ### ### ### ### # #####
#   #     #   #     #   #   # #   #       # #   #   # #       #   #   #   # #   #
##### ### # # # ####### # # # # ########### # ### ### ######### # # # # ### # # #
#     #   # # #   #   #   # #   #   #       # #     # #       # # # # # #     # #
# ### # # # # ### # # ##### ##### # # ### ### # ### # # # ### # # # # # # # ### #
#     # # # # #   # # #     #   # # #   #     #   # # # # #   #   #   # # # #   #
####### # # # # ### # # # ### # # # ### ####### # # # # # # # ##### ### # # # # #
#   #   #     # #   #   # #   #   #     #       # # #   # # # #   #   # #     # #
# # # # # ##### # ##### # # ############# # # ### # ##### # # # # ### # ####### #
# #   # # #     #     #     #           # # # #   # #     #     #     #   #     #
# ### # # # ##### ### ### ### ######### # # # # # # # ############### ### # ### #
#     # # # #   # #     #     #   #     #   # # #   #       #       # #   #   # #
####### # # # # # # # # ##### # # # ### ##### # ### ####### # ##### # # ##### # #
#       #   # #   # # # #     # # #   # #     #   # #     #         #       # # #
# # ######### ##### # # # ##### # ### # # ####### # # ### ################# # # #
# #     #           #   # #     #   # #   #     #   # #   #       #   #   # # # #
# ### # # ####### ### ### # ####### # ##### # # # ### # ### # ### # # # # # # # #
# #   #         # #   #   # #       # #   # # # # #   # #   #     # # # #   # # #
# # ######### # # # ### # # # ####### # # # # # # # ### # # ### ### # # ### # # #
# #         # # # #   # # #   #       # # #   # # # #   # #   #     #     #   # #
# # ### ### # # # # # # # # ### # ##### # ##### # # # ### ### ##### ##### ##### #
# # #   #   # # #   #   # # #   # #   # # #     # #   #     #     # #     #   # #
# # # ### ### # ######### # # # # # # # # # ##### # ### ### ##### # # ##### # # #
#   #         #           #   #     #     #       #               #         #   #
################################################################# ###############

