############### #################################################################
#       #       #         #     #       #     #   #               #     #       #
# ##### # ####### ####### # ### # ##### # # # # # # ############# # ### # # ### #
# #   #   #   #   #         #     #     # # # # #   #   #       #   #   # # #   #
# # # # ### # # # # ####### # ##### # ### # # # ##### # # ##### ##### ### # # # #
#   # #   # # # # # #     #         # #   #   #   #   #     #   #     #   # # # #
# ### ### # # # # # # # # ########### # ######### # # ### # # ### ##### # # # # #
# #       # # # # #   # #     #       #   #     #   #   # # #         # # # #   #
# # # ##### # # # ### # # ### # ### ##### # ### ####### # # # ####### # # # ### #
# # # #     #   #   #   # #   #     #     # #         # # #   #     # #   #     #
# # # # # ##### ### ##### # # ####### ##### # ####### # # ##### ### # ####### ###
# #     #     # #       #   # #       #     #     #   # #   #     # # #     #   #
# ########### # # ##### ### # # # ##### ### ##### # # # ### # ### # # # ### ### #
# #       #     #         #   # # #   # #   #     # # # #     #   #   #         #
# # ##### # # ### ####### ### # # # # # # ### ##### # # # ##### ### ########### #
# # #   #   #   # #     #   # #   # # # # #   #     #   # #       # #     #     #
# # # # ####### # # # # # # # # ### # # # # ### # ####### # ##### # # ### # # ###
# #   # #   #   # # # #   #   # #   # # #   #   # #       # #       #     # #   #
# ### # # # # ### # # # ####### # ### # ### # ### # # ##### # ########### # ### #
#     #   #   #   #   #   #     # #   #     #       #   #   # #   #     #   #   #
# ########### # ######### # ##### # ############# ##### # ### # # # # # ##### # #
# #       #   # #           #     # #           # #   # #     # #   # #       # #
# # ##### # ### # ########### ##### # ### ##### # # # # ####### ##### ######### #
#   #     #       #   #           # #   # #     # # # #       # #   # #     #   #
# ### ##### ### ### # # ######### # ### # # ##### # # ####### # # # # # ### # ###
#       #   #   #   # # #   #   # # #   # # #     #   #         # # # #     #   #
####### # ### ### # # # # # # # # # # # # # # ##### ### # ####### # # # ##### # #
#       # #     # # # #   # # # # #   #     # #   #     # #     # # # #       # #
# ##### # # ### # # # # ### # # # # ######### # # # ##### # ### # # # ######### #
# #     # #     #   # # #     #   #     #   # # # #     #   #   #     #         #
# # ##### ####### ### # # # ########### # # # # # ##### ### # ######### ##### ###
# # #         #   #   #   # #   #     #   # #   # #         #   #           #   #
# # # ####### # ### # ##### # # # ### # ### ##### # ######### # # # ### ### ### #
# #   #   #   #     # #     # # #     #   #     # #           #   #     #       #
# # ### # # # ##### # # ### # # ### ##### ##### # # ########### ######### #######
# # #   #   #       #   #   # #   #       #     #   #       #   #     #     #   #
# # # ######### ##### ### ### ### ######### ######### ##### # ### ### # ### # # #
# # # #       #     # #         # #         #   #   # #   # #   # #   #     # # #
# # # # ##### ### # # # ####### # # ######### # # # # # # # ### # # # # ##### # #
# # # #     #   # #   #       #   #     #   # #   #     # # #   #   # # #   # # #
# # # ##### ### # ##### ### # # ####### # # # ### ####### # # ### ### # # # # # #
#   # #   #     #     # #   # # #     #   #     #   #     # #   #   # #   #   # #
##### # # ##### ##### # # ### # # ### ####### # ### # ### # # # ### # ######### #
#     # #     #   #   # #       # #   #     # # #   # #   # # # #   # #       # #
# ### # # # # ### # # # # ####### # ### ### # # # ### # ### # # # ### # ##### # #
#     # # # # #     #   # #   #   #         # #   #   # #   # #   #     #   # # #
####### # # # # # ##### # # # # ########### # ##### # # # ### ##### ##### # # # #
#       # #   # # #     # # # # #       #   #       #   # #   #     #   # # # # #
# ####### ##### # # ##### # # # # ##### # ######### ### # # ### ##### # # # # # #
# #   #     #   # # #     # #   #       #         #     # # #   #   # # # #   # #
# # # # # # # ### # # ##### ##### ####### ####### ####### # # # # # # # # ##### #
#   # # # #   #   #   #   # #   # #     #   #   #       # #   #   # #   #       #
### # # # ##### # ##### # # # # # # ### ### # # ####### # ####### # # ####### ###
#   # # #       # #     # #   # #   #     #   #     #     #     #     #         #
# ### # ### ### # # # ### ##### ### # ### ######### # ##### ### ####### # ##### #
#     #   #     #   #               #               #                   #       #
######### #######################################################################

