### #############################################################################
#   #     #       #                 #                     #   #   #       #     #
# # # ### # ##### # # ############# # # ####### ##### ### # # # # # ##### # ### #
# # #     #   #     #       #       # # #     #     # #   # #   # # #     # #   #
# # # ####### # # ######### # # ### # # # ### ##### # # ### ##### # # ##### # # #
# # #   #       # #     #   # #     #   # #         #   #       #   # #   #   # #
# # ### # ####### # ### # ### ######### # # ##### ####### ##### ##### # # ##### #
#   #   # #     #   #   #       #       # # #   # #   #   #   # #   # # # #     #
# ### # # # ### ### # # ####### # ### ### # # # # # # # ### # # # # # # # # ### #
#     # #     #   # # #         #     #     # # # # # # #   #   # # #   # # #   #
##### # ##### ### # # ### ####### ##### ##### # # # # # # ####### # # ### # # ###
#     # #         # #   #   #     #   # #   # #     #   # #         #   # #     #
# ##### # ######### ### ### # ##### # # # # # ### ####### # ##### ##### # ##### #
#       #     #     #     #   #   # # #   #   #   #   #   #     #     # #       #
### ######### # # ### ### ##### # # # # ##### # ### # # ### ### ##### # ### ### #
#           # # #     #     #   # # # # #   # #     # # #   #       # #     #   #
# # ### ### # # ####### ### # ### # # # # # # ####### # # ### # ### # ####### ###
# #   # #   #         # #   # #   # # #   #   #     # # # #   #   #   #     #   #
# ### # # ########### # # ### # ### # ######### ### # # # # ##### ### # ### ### #
#   #   # #           #   #   # #   # #             # # #   #         # #       #
# # ##### # # ####### # ### # # # ### # ########### # # ##### ######### # ##### #
# #     # # #       # #     # #   #   # #         #   #     #     #   #   #   # #
# ##### # # ##### # # ##### # ### # # # # # ##### ##### ### ##### # # ##### # # #
#   #   # # #     # # #     #   # # #   # # #     #     #   #   #   # #     #   #
### # # # # # # ### # # ####### # # ### # # # ##### ##### # # # # ### # #########
#   # # # # # #     #   #     #   # #   # #   #   # #     #   # # #   #         #
# ### # # # # ########### ### # ### # ### # ### # # # ######### # # ########### #
# #   #   #     #   #   #     #     # #   # #   # #   #         # # #   #       #
# # ########### # # # # ##### ##### # # ### # ### ##### # ####### # # # # #######
# # #   #     #   # # # #   # #   #     #   #         # # #   #   #   #         #
# # # # # ### # ### # # # # # # # ####### ########### # # # # # ############### #
# #   # # #   # #   #   # # #   #   #                   # # # #     #       #   #
# ##### # # ### # ### ### # ####### # ################### # # # ### # ##### # # #
#     #   # #   # #   #   # #   #   #         #   #         # #   # # #   #   # #
### # ##### # # # # ### # # # # # ########### # # # # ####### ### # # # # # ### #
#   # #       # # # #   # #   # # #   #         #   #         #   # #   # #     #
# # # # ####### # # # ### ### # # # # # ########### ######### # # # ##### #######
# # #   #     # #   #   #   # # # # # # #         #   #       # # #     #       #
# # # ### # # # ### ### # # # # # # # # # ##### # ### # ####### # ##### # ##### #
#   # #   # # #   #   # # # # # #   # #       # #   #           #       # #   # #
##### # ### # ### ### # # # # # # ### ####### # ### ######### ########### # # # #
#   #   #   #   #     # #   #     #     #     #   #         #   #   #       #   #
# # ##### ##### ### ### ########### ### # ####### ######### ### # # # ###########
# # #         # #   #   #           #   #   #   # #       # #     #   #         #
# # # ####### # # ### ### ##### ##### ##### # # # # ##### # # # ##### # ####### #
#   #       #   # #   #       # #   # #   #   #   #         # #     #   #   #   #
# ##### ### ##### # # # ##### # # # # # # ################### ### # ### # # # # #
#     # #   #   # # # #         # # # # # #                 #   # # #   # # # # #
##### # # # # # # # # # ######### # # # # # # ############# # # # # # ### # # # #
#   # # # # # # # #   #   #   #   # #   #   # #     #   #   # # #   #     #   # #
# # # # # # # # # ####### # # # ### ### ##### # ### # # # ### # # ######### ### #
# # #   # #   # #         # # # #     #   #     #   # # #       # #   #   # #   #
# # # ### ##### ##### ##### # # # ### ### # ##### ### # ######### # # # # # # ###
#   # #       #     # #   #     # #       # #   #   # #           # #   # # #   #
# ### # ##### ##### # # # ##### # # # ### # # # ### # ############# ##### # ### #
#     #             #   #       #   #     #   #     #                     #     #
################################# ###############################################

