############################################################################# ###
#         #   #   #                   #         #           #                   #
# ####### # # # # # ################# # ### ### # ### ##### # ########### ##### #
#   #   # # #   # # #   #     #   #   #   # #   #     #     #           # #     #
# # # # # # ##### # # # # ### # # # ##### # # ######### ##### ######### # # ### #
# #   #   #     # #   # #       #   #   #   #     #   # #   # #         #   #   #
# # ########### # ##### ##### ####### # ######### # # # # # # # ############# ###
#   #             #   #     #       # #       #     #     #   #                 #
# ### ############# # # ### ####### # # ### # # ############################### #
# #   #   #       # # # #   #     # # #     #       #     #         #     #   # #
# # ### # # ##### # # # # ### ### # # ############# # ### # ####### # # # # # # #
#       # # #   #     #   #       # #   #     #   #   #   #         # # #   # # #
####### # # # # ########### # ##### ### # ### # # # ### ### ####### # # ##### # #
#   #   #     #           # #     # #   #   # # # #   #   #       # #   #       #
# # # ######### ######### # ##### # # # # # # # # ### ### ##### # # ### # #######
# #   #         #       #   #       # #   # #   #     #   #     #       # #     #
# ### # ### ##### ### # # ### ####### ##### ##### ##### ### # ########### # ### #
#   # # #   #     #   # #   #       #   #   #     #   # #   # #     #       #   #
# # # # # ### ### # ### ### ####### # # # ### ##### # # # # # # ### # ####### ###
# # #   #       # # #     #       #   #   #       # # #   # #   #     #         #
# # ########### # # # ### ####### ####### # ##### # # ### # ### # ##### ####### #
# # #     #     # # #                 #   #         #   #       # #   # #     # #
# # # ### # ##### # ##### ####### ### # ######### ##### ### ##### # # # # ### # #
# #   #     #     #     #         #   #         # #   #   #   #   # #   #     # #
# ##### ##### ### # ### ##### ##### # # ####### # # # ### ### # # # ##### ##### #
#             #   # #   #     #     #   #     # #   # #     # # # #     # #     #
# ############# ### # ### ##### ######### ### # ##### # ### # # # ##### # # # ###
# #       #     #   #   # #   # #         #   #       # #   #   #   #     # #   #
# # ##### # # ### # ### # # # # # ####### # # # ####### # ##### ### # ##### ### #
# #     # # #     #     #   # #   #     # # # # #   #   #     #       #   # #   #
# ##### # # ##### ########### # ### ### # # # # # # # # ##### ##### ### # # # ###
#     # # # #   # #   #       #   # #     #   #   # # # #     #   # #   #   #   #
### # # # # # # # # # # ######### # # ##### ####### # # # ##### # # # ######### #
#   # # # #   # #   # # #     #     # #   # #   #     #   #     # #   #     #   #
# ### # # ##### ##### # # ### # # ### # # # # # # ##### ### ##### ##### ### # # #
# #   #     #   #   # # #       #     # #   # # # #   # #   #   #     #     # # #
# # ####### # ### # # # ########### ### ##### # # # # # # ### # ##### # ##### # #
# # #     #   #   # # # #   #     #     #     #   # # # # #   # #     #     #   #
# # # ### # ### # # # # # # # ### ##### # ####### # # # # # # # # ##### ### ### #
# #       #     # # # #   # # #       # # #     # # # # #   # #   #   # #   #   #
# ### ########### # # # ### # # ##### # # # ### # # # # # ### ##### # # # ### ###
#     #   #     # # # # #   #   #   #     #   #   # # # #   # #     # #     #   #
####### # # ### # # # # # ##### # # ######### ##### # # ### # # ##### ##### ### #
#       #   #   # #   #   #   #   # #     #         #       #   #         #   # #
# ########### ### # ####### # ##### # ### # # ################# # ####### # # # #
#     #     #       #     # #       #       #             #     # #   #   # #   #
##### # ### # ### ### ### # # ########### ############### # ##### # # # # # #####
#   # # #   #   # #   #   # # #   #     # #     #           #     # #   #       #
# # # # # ##### # # ### ### # # # # ### # # ### # ########### # ### # ######### #
# #   # #     # #   #   #   # # #     #   #   #   #           #     #   #   #   #
# # ### ##### # ### # ### ### # ##### ####### ##### ############### ### # # # # #
#   #   #     #     # #   #   #             #   #     #       #     #     #   # #
# ### # # ########### # ### ######### ##### ### # ### # # ### # # ### # ##### # #
# #   # # #           # #             #     #   #     # # #     # #   # #   #   #
# # ### # # # ######### # # ########### ### # ######### # # ##### # # # # # #####
#       #   #             #                 #           #           #     #     #
############################################################################### #

