######################### #######################################################
#       #               #             #   #                 #           #       #
# # ### # ############# ########### # # # # # ############# # ####### # # ##### #
# #     # #     #     #       #   # #   #   #   #           #   #   # # # #   # #
# ####### # ### # ### ##### # # # # ### # ##### # ######### ### # # # # # # # # #
#   #   #   #     #   #     # # #       # #     # #         #   # # #   # # # # #
### # # ### # ##### ### # ### # ######### # # ### # ######### ### # ##### # # # #
#     #     # #     #   # #   #     #     # # #   # #   #     #     #     #   # #
# # ##### ### # ##### # # # ####### # ##### # # ### # # # # ### ##### ####### # #
# # #   # #     #     #   # #     # # #   # #   #   # #   # #   #   # #     # # #
# # # # # # ##### ######### # ### # # # # # ##### ### ##### # ### # # # ### # # #
#   # # # # #     #       # #   # #   # # #     # #   #   # #     # #       # # #
##### # # # # ### # ##### # ### # ##### # # ### # # ### # # ####### ### ### # # #
#     # # # # #   # #     #   # # #       # #   # # #   #   #         #   #     #
# ##### # # # # ### # ### ### # # # ####### # ### # # ##### # # ### # ### ### ###
# #     # #   # #   #     #   # #       #   #   #   #     # # #   # #       #   #
# # # ### ##### # ######### ### ### ### # # ### ##### ### # # ### # # ##### ### #
# # # #         # #           #   # #     #     #   # #     #   # # # #     #   #
# # # # ####### # # ### ##### ### # # ####### ### # # # # ##### # # # # ##### # #
# # # # #     # #       #   # #   #   #     # #   #   # # #   # # # #   #     # #
# # # # # ### # ######### # # # ####### ### # # ####### # # # # # # ##### ##### #
# # # # # #     #         #     #         #   #   #   #   # #   #       # #   # #
# # # # # # ##### ####### ####### ####### # ##### # # ### # ########### # # # # #
# # # # # # #   # #     #     #   #   #   #       # #   # #     #       # # # # #
# # # # # # # # # # ### ##### # # # # # # ######### # # # # ### # ##### # # # # #
# #   # #   # # # #       #     #   #   # #         # # # # #     #     # # #   #
# ##### # ### # # ####### # ############# # ######### # # # # ##### ##### # ### #
#     # # #   # # #       # #     #       #     #     # #   #   #       # #   # #
# ### # # # ### # # ####### # ### # ########### # ##### ####### # ##### # # # # #
# #   # # # #   #           # #   # #     #       #   #   #     # #     # # # # #
# # ### # # # ############### # # # # ### # ####### # ### # ### # # ### # # # # #
#         # # #       #       # # #       #     #   # #   #   #   #     # # #   #
####### ### # # ##### # ##### # # # ########### # ### # ##### ### ####### # ### #
#           #   #   #   #   #   # #     #     # # #   # #   #   #         #   # #
# # ############# # ### # # ##### ##### # # # # # # # # # # ### ############# # #
# #               #   # # # #   # #       # # #   # # # # #             #     # #
# ############### ### # # # # # # # ####### # ##### # # # ############# # ##### #
#   #             #     #   # #   #         # #   # #   # #     #         #   # #
### # ############# ##### ### # ############# # # # ##### # ### # ######### # # #
#   # #         #   #     #   # #   #     #   # #   #     #       #       # # # #
# ### # ####### # # # ### # ### # # # # # # ### ##### ######### ### ##### # # # #
#   # # #   #     # #     # #   # #   # # # #   #     #       # #   #   # #   # #
### # # # # # # ### # ##### # ### ##### # # # ### ##### # ### # # # # # # ### # #
#   # # # #   # #   #       #         #   #   #   #     # #   # # #   # #   #   #
# ### # # ##### # ########### ####### ######### ### ##### # ### # ### # # # # ###
#   # # #   #   #     #     # #           #       #       # #   #   #     #     #
### # # # # # ####### # ### # # # ####### # ##### ####### # # # ### ########### #
#   # #   #   #       # #   #   #     #   #     # #       #   #   #     #       #
# ### ##### ### ####### # # ######### # ### ### # # # ########### # ### # #######
# #         #   #       # #           # #     # #   # #           #     # #     #
# # ######### ### ####### ######### ### # ### # ##### # ################# # ### #
#   #     #   #     #   #           #   # #   #         #     #           # #   #
### # ### # ### ### # # # ##### ##### ### # # ####### ### ### # ######### # # # #
#   # #   #       # # #   #   # #   # #   # #   #     #       # #   #   # # # # #
# ### # # ####### # # ##### # # # # # # ### ### # # ### # ### # # # # # # # # # #
#       #         #         #     #   #         # #     #     #   #   #     #   #
################################################# ###############################

