############### #################################################################
#             #   #   #   # # #   #     #     #   #   #   #       #       #   # #
### ### ### ### # # ### # # # # # # ### ### ##### # # # ### # # ### ### ### # # #
#     # #   #   #   # # #   #   #   # #     #   #   #   #   # # #   #       #   #
# ####### # ##### ### # ##### # ##### # # ### # # ##### # ####### # ########### #
# #   # # #       #   # #     # # #   # # #   #   #   #   #   #   # # #   #     #
# # ### # ##### ### ### ### ##### # # ### # # ### # ### ### ####### # ### ### # #
#   #   #   #   #       # # #     # #   # # # # #   #       # #     #     #   # #
# # # # # # ### # # ### # # # ### ### ### ##### # # ##### ### # ##### ### ### ###
# # # #   #   #   #   #         # #   #   #   #   #   #   #   #   #   #   # # # #
### ### ### ### ### ### ### # ### # # ### # ####### # ##### ### ### ### ### ### #
#   #   #   # # #   #   # # #   #   #   #   #       #           #   # # #   #   #
# ### ### # # ### ### # # ### # # ### ### ### ### ### ####### ### ### # # ### # #
# # # #   #     # # # #   # # # # #   # # #   #   #   #     # #   #   #   # # # #
# # ### # ##### # # ### ### ####### ### # # ####### ### ### ### ### # ### # ### #
#   #   #   #   #   # # #       #   #       #   #   #   # # #   #   # #         #
# ####### # # ### ### ### ##### ########### # ### ### ### ### ### ### ### #######
# # #   # # # #   # # #   #   #   #       #   # # #               #   #   #     #
# # ### ### ####### # # ### ### # # # ##### ### # # ### # # ### ### ### # # # # #
#   # #         #       #   # # # # #   #   #   #   #   # # # # #   #   #   # # #
##### # ##### ### ##### # ### ### # # ### # # ### # # ### ### ########### # #####
# #   #   #       #   #   # # # # # #     #   # # # # #   #   #       #   #   # #
# ### # # ##### # # ####### # # ####### # ##### ### ### ### ####### ####### # # #
# # #   #   #   #   # #   # #   #   #   #   #   #     # #   #   #   #   #   #   #
# # # # ####### ##### # ### # # ### ### ### # # ##### ### ##### # ### ##### # # #
#   # #   #   #   #   #       #   #     #     #   #       #       #   #   # # # #
### # # ### # # ### ### ### # # ### # ##### ####### ##### # # ##### # # ####### #
#     # #   #   #   #   # # # # #   #     # #   # #     #   # #   # #   #   #   #
# ##### ##### ### # # ### ### ### ### ####### # # # # ### ### ### ### ### #######
# # # #   #       #       # #   # #   #     # #   # #   # #             # #     #
# # # ##### # ##### ####### ### ####### ####### ####### ### ############# ### # #
# #         # #   # #   #   #       #     # #   #       #   #                 # #
# ######### # ### # # ### ### ##### # ### # # # # ### ####### ### ####### # #####
#     #   # #     #   #           #   #   #   # # #   #   #   #   #   #   #     #
####### ### # # ##### ### # ####### # # # # ### ####### ### ### ### # ######### #
# #         # # #   # # # # #       # # #     # #   #   #   #   #   #   # # # # #
# # ##### ### ##### # # # ####### ### ##### ####### # ### ### # # ### # # # # ###
# #   #   #   #   #     # #   # # #     #     #   #   #   #   #   #   #         #
# ##### # ##### # ##### ### ### ### ### ### # # ### ### ####### ### # # # # ### #
#       #       #   #         # #   #   # # # #     #   #   #   #   # # # #   # #
# # ######### ### ### ### ### # ##### ### # ##### ### # ### # # ####### ##### ###
# #       #     # #   #   #   #   #   #   #   #   #   # # #   #   #   #   #     #
####### ### ### ### ### ####### ####### ### ### ### ##### # # # ### # ##### # # #
# #       #   # #   #   #       #   #   #   #   #   # # # # # #     #     # # # #
# ##### ##### # ####### # ### ### ### # # ### ### # # # # ### ### ##### # ### # #
#     #     # #   #   #   #       #   # # # # #   # #       # #   #     # #   # #
# # # # ####### # ### # ### # ##### # # ### # # ### ##### ##### ##### # ### # ###
# # #   #       #     # #   #   #   # # #       #       #   #       # # #   #   #
# ### ### ####### ### ### ### # # # ##### ### ####### ### # ##### ### # # #######
# #     # #   #   #   #   #   #   #   #   # # #   #   #   #   #   #   # #       #
### # # # # ########### ### # ####### # ### # # ####### ### ##### ##### # #######
#   # # # #     #   #   # # #   #   #   #   #   #   #   #   # # #     # #       #
# # # ### ### # # # # # # ### ### ### # # ### ### # # # ##### # ##### ####### ###
# # # #       #   # # #   #   #       #   # #     #   #   #     #     #   # #   #
### # # # # ### ### ### ### # ##### ### ### # # ### ### ### ### ####### ### # # #
#   # # # # #   #   #   #   #   #   #       # # #   #       #               # # #
########################################### #####################################

