################################################################# ###############
#     #   #   #       # # #       #       # #             # #   # #   #         #
# ##### ### # ### # ### # # ### ### ### # # ### ### ####### # ### # # # ### ### #
#   #     # #     # #     # # # #   #   #   #   # # #   #   #   #   #   # # #   #
# ####### ### ### ### ### # # ### ### ##### # # # # ### # ### # # # ##### #######
# #   #       #       #   #   #   #   #       #   #   #       #   #   #   #     #
# # ### # ##### ####### ### # # # ##### ### ### ### # # ### ### # ##### # # ### #
#   #   #   # #     #   #   #   #   # # #   # # #   #   #     # #   #   #   #   #
### # ### ### ### ### ### ### ### ### ### # # ####### ################### ### # #
# #   #   #   #   # # #   # # # # #       #   #       # # #           #   # # # #
# # ##### # ### ### ### # # ### ####### ### ##### ### # # # ### ####### # # ### #
#   # # #   # # #   #   #   #   #   #   #   #   #   #       #   #       #   #   #
### # # ##### ##### # ### ### # ### # # # ### # ####### # ####### ####### # #####
# #   #   #     #     # #     #   #   # # #   #       # #     #       #   #     #
# ### ### # ### ### ### ### # ####### ######### # # ##### # ### ##### ##### #####
#   #       #   #   #   #   # #   # #   #   #   # # #   # # #   #   #     # #   #
# ### ######### # # # # ### # ### # # ### ### # ##### ### ### # # ### ##### # ###
#     #   #       #   #   # #     # # #   #   #   #   # #     #     # # #       #
### # # ### # ##### # # ### ### ### ### ### ### ### ### ### # ### ##### ### ### #
#   #   # # # #     # # #   # # #             # #   #   #   # # #   #   # # #   #
# ### # # ### ### # ### ### # ### ####### ### ##### # ### # # # ##### ### #######
# # # #   #   #   #   # # #   #   #   #   #           #   # # #   #   #         #
### # ####### ######### # # ### ### ### ### ### # # ### ### ### # # ### ### ### #
#       # #     # # #   #       #   # # #   #   # # #   #       #       #   #   #
# ##### # ### # # # # # ### # ### # # # ######### ### ### ##### ### # ##### #####
# #       #   # #     #   # #     #   # # #   #   #   #   #   #   # #     #   # #
### ### ########### ####### ### ####### # # ### # ### # # # ########### ### # # #
#   #       #   # #   #     #   # #   # #       #   # # # # #       #   # # #   #
##### # # # # ### ### ### ### ### ### ### ### # ####### # # # ####### ### ### ###
#     # # #       #   #   #   #       # # #   #     # # # #   #   #   #   #     #
### ### ### ### ### ### ##### # ### # # ### # ### ### # ### ### ### # # ##### # #
#   #   #   #   # # #   #   #   #   #     # # #   #   # #   #   #   #   #     # #
### # # ##### ### ### # ### # ### ########### ### ### ### ### ####### ###########
#   # #   # # #     # # #     #       #   #   #     # #           # # #         #
### ### ### ##### ##### ### ### # ####### # ### ### # # ### # ##### # # ### #####
#     # #         # #   #   #   #   # #     #   #   #   #   #       #   #       #
# ### ### ####### # # ### # ##### # # ### ### ####### ### ### # ##### # ##### ###
# #       #   #   #     # # # #   #   #   #   #   #   #   #   #   #   # #     # #
### ##### # ####### ### # ### # # ### # ### # # # # ### ### # # # # ### ### # # #
#   #   #   # #       # #   # # #   # # # # #   #   #   #   # # # # #   # # #   #
# ##### # ### ### ### ### ### # ##### ### ### ### # ##### # ### # ### ### ##### #
# #       #         # #       #     # #   #   #   #   # # #   # # #   #   #   # #
# # ### # ######### # ##### ####### ### ### ### ### ### ####### ### ### ### #####
# # #   #     #     # # #       #   #   # # # # #   #   #   #   #             # #
# ### # # ### ### ### # ##### # ##### ### ### ####### ##### ######### ### ##### #
# #   # # #   #   # #   # #   #             #             #   #   # # # # #     #
### # ####### ### # ### # ##### ############### ### ### ### # ### # # # ### ### #
#   #   #       #   #   #   # #       #         #     # #   #       #       #   #
# ##### ######### ### ### ### ### # ##### ### ### ### ### ### ### ####### ### ###
# #   #   #   #   #           #   #       #   # # # #     #   # # #   #   # #   #
### ### ### ### ### # ######### ### ### ### ### ### # ######### # # ### ### # ###
#         #     # # #   # # #     # # # #   #   #       # # #   # #     #   #   #
### # ####### # # ### ### # # # ### # ### ### ####### # # # # ########### ### ###
#   # #       #   #   #   #   # #     # #     #       #       #       #         #
### ##### ##### ### # # ##### ##### ### ### # # ### ### ##### # ### ### ### ### #
#       #   #   #   #     #     #       #   # # #   #   #       #   #   #   #   #
####################################################################### #########

