################################# ###############################################
#   # #       #   #                 # #         # #       #   #   #     # #   # #
# ### # ######### # # # ### ### ##### ##### ### # # # ### # ### ### # ### # ### #
#   #   #     # #   # # # # #   # # # # # # # # # # #   #   #   #   # # #   #   #
### # ### ##### # ### ### ####### # # # # # # # # ### ### ### ####### # # ### ###
#     # # #   # # #   #     #     #         # # #     #       #           #   # #
##### # # # ### # # # # ##### ### # ### ##### ######### ### # # ### # # ### ### #
# #     # # #     # #   #   #   #   #     #     #   #   #   #   #   # # #   #   #
# ### # # # # ### # ##### ### # # ### ##### ##### ####### # # ### ### # # ### ###
# #   #   #   #   #   #   #   # # #   #       #           # # # # # # #   #     #
# # ### ### ### # ### ### ### # ### ### # # ####### # # ### # # ### ### ### ### #
#   #   #   #   #   #         # # # #   # # #   # # # #   # #   #   # # #   #   #
### # # # # ##### ### ### ### ### ####### ### ### ### ##### ##### # # ### ### ###
#   # #   #   # # #   # # #   #   #       #   # # #   #   #   # # #   # # # # # #
### ##### ##### ### # # ### # # ### # ##### ### # # # # ### ### # ##### # # ### #
#   # # #   #   #   #   #   #   #   #   #   #       #   # # #         #         #
# # # # # # # ### # # ### ### ### ######### # ### # ##### ### # ######### #######
# #   #   #   #   # # # # #   #   #   #   #   # # #   #   #   #   #             #
### ### ### ### ####### # # ### # # # ### # # # ### ##### # ### ### ##### ##### #
#   #   #   #   #   # #   # #   #   #   #   #   #     # #   # #       #     #   #
# # ##### # # # ### # ### # # # ##### # # ### ### # ### # # # # ### ##### ### # #
# #   #   # # #   #     # #   #   #   #   #   #   #   #   # #     #   #   # # # #
### # ##### ### ### ### # # ### ##### # ######### # # # ### ### # # ####### # ###
#   #   #   # # #   #   # #   # #   # # #       # # #   #   #   # # #   #       #
# # ##### # # ##### # ### ### ### ### ### ### ### ####### ### # ##### # #########
# # # #   #   #   # # #   #   #   #   #   # # # #     #   #   #   # # #       # #
### # # # ####### # ####### ### # # ### # # ### ### ### ### ####### ### # # ### #
# #   # #   #   #         # # # #   #   #         # #   # # #       #   # # #   #
# # ### ### # ### # ### ##### ### # # ##### # ### ### ### # # ####### ####### ###
# #   #   #   #   #   #   #   #   #   #   # #   # # #     # #     #           # #
# # ### ### ### ####### ### ### ### ### ### ### ### ########### ####### # # ### #
#   #   #         # #   # # #   #       # # #       #       # # #       # # #   #
# # # ### ### # ### # ### # # ### ### ### ### ### # # ##### # # ### ####### ### #
# # # #   #   #   # # #   #   #     # #     # #   #       #       #   # #     # #
### ####### ### # # ### ##### # # ### # # # ### ### ##### ##### ### # # ####### #
#       #   #   #   #   # #   # #   #   # # #   # #     #   # # # # #   #       #
# ####### ### # ##### # # ### ### # # ### ### ### ### ####### # # ### # # #######
# #       #   #   #   #   #   #   # #   # #       #   # # #       #   #   #   # #
# ##### ##### ##### ### ####### ########### ##### # ### # # ##### # # # ##### # #
#     # #           #   #   # # #   #   #   #   # # #       #   #   # #         #
# # ### ### # # ##### ### ### ### # ### # ### ##### ######### # # # # ##### # # #
# # # #   # # # #             #   #   #   #   # #       # #   #   # # #   # # # #
### # # # ##### ### ### ##### # # ### # ### # # ##### ### ######### ### ####### #
#   #   #   #   # # # #     # # # #   #     #       # #     #       #       #   #
##### # # ### ### # # ##### ##### ### ### # # ### ######### # ##### # ####### ###
# #   # # #     # #   #           # # #   # # #     #   #     #       #   #   # #
# # # ### # # # # # ### ### # # # # ### ### ### ####### ### ####### ### ####### #
#   #   # # # # #   #   #   # # #   #     #   # #   #       #   # #     #   #   #
### # ### ####### ##### # # ####### ######### ### ### ### # # ### # # # # ### ###
#   # #       #     # # # #       #   #   #   #   # # #   #   #     # #   #   # #
# ##### ####### ##### # ####### # ### # # ##### ### ### ########### ####### ### #
# # #       #   #   #   #   #   #   #   #       #   #   #   #   #   #       #   #
# # ##### ######### # ### # # # ##### # ##### ### ####### # # # # ### ### ### ###
# #       # # #       #   # # # # #   #   # #     #       #   #   #   #   #   # #
# # ### ### # # ##### # # ### # # # ### ### # # ######### ####### # ### # # # # #
# #   # #       #       #   # # #   #       # #     #       #       #   #   #   #
##################################### ###########################################

