############################################################### #################
# # # #   #   #     # #   #   #   #     # #       #   #   #   #           #     #
# # # # ### ### # ### # ### ##### # ##### ##### ### ### ### ### # # ### ### # ###
#   #   #   #   #   #   #       #   #   #       #   #       #   # # #   # # #   #
# # # # # ### ####### ### # ##### ### # ##### # # ##### # ##### ##### ### # #####
# #   #   #       # # #   #   #   # # #     # #   #     # #       #   #         #
### ### # # ### # # # # ####### ### ### ### ##### ### ##### # # ####### ### ### #
#   #   #   #   #   #       #       #     # # # #   #   #   # #   # #   #     # #
### # # # # ##### ### ####### ####### # ##### # # # # ### ##### ### # ### ### ###
# # # # # #     # #   # # #       # # #     #     #   #       #       #   # #   #
# # ### ####### ### ### # # ### ### # ### # ### ### ### # # ##### # ##### # #####
#   # # #   #   #   #       #   #     #   #     # # # # # #   # # # #   #   #   #
# # # ### # ##### ### ### # ##### ### ### # ### # ### ### # ### ##### # ##### # #
# #   #   #   #   #   # # #   #   # # #   # #     #   #   #       #   # # #   # #
##### # # ##### ### ### ### ### ### ### ########### ####### ########### # # # ###
#       #   # #   # #   #   #   #   # # #   #               #     # #       #   #
# ### # ##### ### # # ####### # # # # ### ### # ####### ##### ##### # ### #######
#   # #           # # #   #   #   #       #   #   #   # # #   #   #   # # #   # #
# ##### ######### # # # # # ##### ######### # ##### ### # # # # ### ### ### ### #
#   #     # #   #       #   #   #       #   #   #     #     #       #       #   #
####### ### # ### ### ### # # ### ####### ####### ##### # ### ### ### ####### ###
#             # # #   # # #   # # #   #   # #     # # # # # # #         #     # #
### ### ##### # ##### # ### # # ##### # # # ### ### # ### # # # ### ####### ### #
#   #   #           #   #   #   #       #   #   #       #   # # #   #       # # #
##### # # # ##### # ### ##### # # ########### ### ### ### ### ####### ### ### # #
# #   # # # # #   #   #   # # #       #     # #   #   #   #       #   # # #     #
# ##### ### # ##### # ##### ####### ####### # ### ######### # # ##### # ### ### #
#       # #       # #   # # #   #   # # # # #         # #   # # #   #   #   #   #
# ### # # ### ########### # # ####### # # # # ### ### # # ### # ### # ### ### ###
# #   #     # #   # # #   #   #       #         # # #   #   # #       #   # #   #
### ### ### ### ### # # # # # ##### # # ### ### ### ####### ####### ### ### #####
# # # # # #     #   # # #   #   #   #   # # # # #       #   # #     #   #   #   #
# # # ### ### # # ### ### ####### ####### ### ####### ### ### ####### ##### # ###
# #   #   #   #           #   #   #   #       #   #     # #   # #     #   #   # #
# # ##### # ### ### ##### # ### # ### # ### ### ##### ##### ### ### ##### # ### #
# # #       #   # # # #     #   #   #   #   #   #   #       #   #   #           #
# # # ####### ### # # ### ### # ##### ####### ### ### ####### ### ### # # ### ###
#   # #       #       # # #   # # #           #   #   #       #   #   # # #   # #
### ### ### ### ### ### ### # ### # ### ### # # # # # # ######### # ### ##### # #
#   #   #   #   #   # #     #       # #   # #   # # #   #           #   # # #   #
##### ### ### ##### # ### ### ####### ### # # # ##### ### ### # # ### # # # # # #
# #   # # #   #     # #   # #     #   #   # # # #     #   #   # # #   #   #   # #
# # ### ### # ##### # # ### ##### # # ##### ####### # # ### ### ### ####### # # #
#   #   #   # #   # #   #   # #   # #     # # # #   #     # # # #   #   # # # # #
# ### ### ### ### # # ### ### ### ### ####### # # # ######### ### ### # # #######
# #   # # # # #       #       #           #       #   #   #   # # #   # # #     #
# # ### ### ### ### ### # ######### # # # # ####### # # ### ### ### # ### # #####
#   #       #   #   #   #       #   # # #   #   #   #   #   #   #   #   #   #   #
# # # ##### ### # # # ### ####### ### # # # # # ##### ### ### ### ### ### # # ###
# # # # #     # # #   #   #   # # #   # # #   #   # #     #   #   # # #   #   # #
### # # ### # ##### ####### ### ### ### ### ####### ### ##### # ### ### ### # # #
#   #   #   #   #   #   #   #   #   #     #       # #   #       #       #   #   #
# ### ### ### # # ### ### ### ### ### ### ### ### # ##### ##### # ####### # #####
# # # # #   # #   #   #       # #   # # #   # # #     #   # # #   # #     # #   #
# # ### ### ### # # # # ### ### # ##### # ##### # ##### # # # # ### # ##### ### #
#       #   #   #   #     #     #   #       #           #   #       #   #       #
##################################### ###########################################

