##### ###########################################################################
#                 #   #           #           #           #       #     # #   # #
# ### # ##### # ### ### ### ### # ##### # ##### ######### # ####### ### # # ### #
#   # # #   # # #   #   # # #   #       #   #         #     #   #   #   #     # #
# ### ##### # # # ### # # # # ### ### ####### ### ### ### ### ####### # # ##### #
# #   #   #   #   #   #   # # #   #   #   #     # #   #   #   #   #   #   # # # #
### ### ### ### ####### ### ### # ### # ### # ### # ### ### # ### # ### ### # # #
# # #     # #   #   #   #   #   #   #   #   #   # # # # #   #   #   #   #   #   #
# # # # ##### ### ### ####### ######### ##### # ##### ### ### ### ####### # # ###
#     #   #   #       #   #   #       #   #   #   #   #   #   #   #   # # #     #
### # ### ##### ### # # ### ### ### ### # # # ##### # # ### ### ### ### ####### #
#   #   #     # #   #   #   # # #     # #   #   #   #   # # #   #   #   #   # # #
# # ######### ### ### # # ### ### # # ### ### # ##### ### # # ### # ### # ### # #
# #   #   #       #   # #   # #   # # #   #   #   # # #   #   #   #   #       # #
### # # # ##### # # # # ### # ### # ##### ##### ### # # ### ### ### ### ### ### #
#   #   # # # # # # # # # # # # # #     #   # # #   #   # # #   #   #   #       #
# ### ### # # ### ### ### ### # # ### ### ### ##### # ### ######### # ### # #####
# #   #   #   #   #   #             # # # #   # # #         # #   #     # #     #
# # ### ### ### # ### ### # ### # ##### ### ### # # ### ##### ### # ### ####### #
# # #   #       # # #     # # # #   # #     #       # #     #   #   # #     #   #
### ######### # # # ##### ### # ##### ### # # ### # # ### ### ### # # # # ### # #
# #       #   # # # #         # # #       # # # # # # #   #   #   #   # # #   # #
# ##### # ##### # # ####### # # # # ### ### ### ### # ### ### # ##### ######### #
#       #   # # #       #   # # #   #   #   #   #       #       #   #   #     # #
# ####### ### ### ### ### # ##### ### ######### # ### # # # # # # ### ####### # #
# #   #         # #   #   # # #   #   #         #   # # # # # #   #   #   #   # #
##### ##### ########### # # # # ### ### ### ### # ######### ### # ##### ##### ###
#       #     #     #   # # #   # #     #   #   #       # # #   # # #   # # #   #
# ####### ##### ##### # ### # ### # # ### ### ### ### # # # ####### ### # # # ###
#         # #         #   #   #   # # #     # #     # # #     #   #   #   #   # #
### ### # # ### ### ### # # # # ####### ####### ### ### # # ### ### ### ### # # #
#     # # # #   #   # # # # # # #   #   #   #   #   # # # #         #   #   #   #
# # ##### # # ### # # ####### # # ### ### ##### ##### ######### ##### # # ### ###
# #   #   #   #   #   #   #       #   #   #   #       #       #   #   #   # # # #
######### ##### ### ### ####### ####### ### ### ### # # ### # # ### ### # # ### #
#   #   #   # # #   #   #   #       #   #   #   #   #   # # # # #   #   #   #   #
# ### # # ### ### ### ### ### ### # # # # ### ### ### # # ### ### ### ### # # # #
#   # #   #   #   #       #   #   #   #   #   # # #   #     # #   #   # # #   # #
### # ### # # # ### # # # # ### ####### ### ### ### # # # ######### # # # # # ###
#       #   # # # # # # #   #   # #     #   #     # # # #   #       #   # # # # #
### ##### # ### # ####### ### # # ### ### ### ### ### ### ### ### ####### ##### #
# #   # # # # #   # # #   #   #     # #       #   #   #         #     # # #   # #
# # ### ### # # ### # # # ### ##### ### ### ########### ### ####### ### # ### # #
# # #   #   #   #   #   #   #   #   #   # # #           #   # # #   #     #     #
# ### # ##### ### ### ### # ### ##### # # ######### ##### ### # ##### ####### ###
#     #       #   #   #   #   #       #       #       #       #   #       #   # #
# # ### ### ##### # ### # # ####### ### ### ####### ##### ##### ##### ### # # # #
# # #     #     #   #   # # # #     # # #   #   #   # #         #   #   #   #   #
# ### # ##### ### # ######### ### # # ### # # ##### # ### ### ### ### ### ### ###
# #   #   #   #   # #     #   #   #   #   #   #   #     # # #     #     # #   # #
### ### ### ### ### ##### # ### ### ### ####### ### # ##### ### ### # ### # # # #
# # #     # # # #   #       #     # # # #   #       #   #       #   #   # # #   #
# # ##### ### # ### # ##### # # # # # ### # # ### ####### ########### ####### ###
#     #     #     # # #   #   # # #     # # # # # # # #   #       #       # #   #
# # ##### ### # # # ### ### ### ####### ### ### ### # ### ##### # ### # ### # ###
# #     # #   # # # #       #       #               #       #   #     # #       #
############################################################################# ###

