############################################################### #################
#     #           #   # # #       #   #           #   #       #   # #       # # #
# ##### # ##### ### ### # # ### ### ### # ##### ### ### ####### ### ### ##### # #
#   #   # #     #     # #   #   # # #   # # # # #   #   #   #   #       #   #   #
# # # # ####### # ##### # ### # # # # ### # # ### ### ### # # # # ### ### ##### #
# #   #   #       #       # # #   #   # # #   #   #   #   #   #   # # # # # # # #
# ######### ### # # # ##### # # ### # # ### ### ### # # ####### # # # # # # # # #
#         # # # #   #   #   # # #   #   # #     #   # # #   #   #   #   #   #   #
# ### # ##### ### ### # # ####### ##### # # ### # ### ### ### # # ##### # # ### #
# #   #   # # # # #   #   #   #       #   #   #   #   #       # # # # # # #   # #
### ####### # # ########### # # ########### ##### ######### # # ### # # ### ### #
#   #           #   #     # #   #   # # # # #         # #   # #     #   #     # #
# # # # # ### # # # # ### ### ### # # # # ### ### ##### # # ##### ####### # ### #
# #   # # #   #   #   # # #   #   #   #   # # #     #     #   #     #   # #   # #
### ### ### ### ### # # ### ### ##### # ### ### ### ### ####### # ##### ##### # #
#     #   # #   #   #   #   #   # #               #         #   #   #   #   #   #
##### # # ####### # ### # ####### ### ### # # # ### # ### # # ####### ##### # ###
# #   # # #   #   #   #   #   #       #   # # #   # # #   # #     #   #         #
# # ### ### # # ### ####### ### ### ### ########### ### ####### ### ### # ### ###
#   #   # # #   #       #   #   #     #       #     #         # #       # #     #
### ##### ### ### ### # # # # ### # # ### ####### ### ### # # ### ### ### ##### #
#     #   # # #   #   #   #   #   # # #   #     # # # #   # # #   #   #   #   # #
### # # ### ### ### ### ### # # # # ### # # ##### # # ### ######### ### ### ### #
#   #   #   #     # #   #   # # # # # # #   #   #   # #     #       #       #   #
# ### ### ### # ##### # ##### ### ### ### ##### # ####### ### ### ### ####### # #
# #   #       #     # # # #   # # #       #     # # # #   #   #   # # #   #   # #
# ##### ### ##### ### ### # ### ### ### ### ### ### # # ### ####### ##### ##### #
#   #   # # #   #   #   #       #   # # #   #   #   #   #   #   #   #     # #   #
# ### # # # # ### ### ### ### # ##### ### # ##### ####### ### # # ### ### # # # #
# # # # # #   # # # # #   #   #   #       #   #   #   #       #       #     # # #
### ### # ### # ### ####### ### ####### ### # # # # # # ### ### ### ### # # #####
#   #       #   #       #   #   #       #   #   #   #   #   # # #     # # # #   #
# # # ### ### # ### # ### ####### ### ### # # ### # # ### # # ### ### # # # # ###
# #   #   #   #   # #     #   #   #   #   # # #   # # # # #   #   #   # # #     #
# ##### ### # # ##### # # # ### ### ### ### ##### # ### ### # # # ##### ### #####
#     # #   # # #   # # #   #   #   #   # # #   # # # # # # # # #   #   # #     #
# # ##### # ##### ### ### ### ####### ### # # ####### # # # ##### ### ### ### ###
# # #   # # # #   # # # #           # #   #               #   #   #   # # #     #
# ##### ### # # ### ### # # ### ####### ### ### # ######### # ######### # ### # #
#   #   #     #     #     # # #     #   #   # # #   #   #   #     # #       # # #
####### # ### ### ######### # ####### ### ### ### ### ##### # ##### # # # ### ###
#     #   # # #   #   #   #       #   #   #   #   #       # #         # # #     #
##### # ### ### # ### ### # ### # ### # ### ########### ### # # ### # ### ##### #
#     # #       # # # # #   # # #   # #         #       #   # # # # #   #   #   #
# ### # # ### # # # # # # ### ##### # ##### # ### ### ### ### ### ### # # ### # #
# # #     # # # # #       #   #       # #   # #   # #     #       #   # # #   # #
### # ##### ####### ### ### ### ### # # ### ### ### # # ####### ####### ### ### #
# # #   #   # #     #       # # #   #     # # # # #   # #     # #     # # # # # #
# # # # # # # ### # ####### # # # ##### ##### ### ##### # ##### # ####### ### # #
# #   #   #   #   #     #     # # #   #   #   #   #       #   #   #       #   # #
# # ### ### ### # # # ##### ### # # ### # ### # ####### ### ### ### ### ### # # #
#   #   #   # # # # #   # # #   #   #   #   #   #   #   #       #   #   #   # # #
# # ##### # # # ######### # ##### ### # ##### ### ### ### ### # # ### ### ### # #
# #   # # #   #   #   #   #   #   # # #       #   #   #   # # #   #   #   #   # #
# ##### ### # ### ### # ####### # # ### ### # # ### ##### # ### ##### # ### #####
#   #       #   #   #           #   #   #   #   #       #   #       #   #       #
############################################### #################################

