################################# ###############################################
#     #   #     # # #                 #   #       # # #     #       #     #   # #
### ### ### ### # # ### ####### ### ##### # ### # # # ##### ### ####### ### # # #
#       #   # # #       #   # # #     #     #   #   #   #       #     #     #   #
# ##### # ### ### ######### # # ### # ### ### ### ### # # ##### # ##### ##### ###
# #   #   #   #   #           #   # #     #   #   #   #   #   #   #     # #   # #
# # # # # # ### # # ############### ####### # # ####### ### ########### # ##### #
#   # # #   #   #   # #       # #   #     # # # #   #   #   #   #     #         #
# # # # # ### ##### # ### ##### ##### ### # ##### ### ### ##### # ####### ##### #
# # # # # #   #   #   #   #           #   #   #   #   #   #   # # # #   # #   # #
### ####### ### ### ### ### ### ####### # ##### ### # # ##### # # # ### # ### ###
#     # #       # #     #   #       #   #   #     # #   #       # # #   #   #   #
##### # # ### # # ### # # # # ####### ### ### ####### ######### # # # # # # ### #
# #       #   #   #   #   # #     #   # # #   # # #       #   #       #   # # # #
# # ##### # ### ### # ##### ### ####### ### ### # ##### ### # # ### ### # # # # #
#   #     # #   #   #   #     # # # #   #       #   # # #   #   #   #   # #     #
# ####### ### # ##### ### ####### # ### ##### ### ### # # ### # ##### ##### ### #
# #   # # # # #   #   #   #   #   #       # #     #   #   #   #   #       #   # #
# # ### # # ### # ####### ### # # # ### ### # ##### ### # ######### ### ### # # #
#       #   #   #   #   #       # # #         #         # # # #   # #   #   # # #
# ### ### ### # # ### # # ### ### ####### ### ### ### ##### # ### ### ### ### ###
# #   #   #   # # #   # # # # # # #       # # #   #       #   #   # #   # #   # #
####### ### ### # # ####### ### ### ### ### ### ##### ### # # ### # ### ### ### #
#   #   # # #   #   #       #   #   #   #   #   #       #   #   # #     #   #   #
# # # ### ### # ### # ### ### # # # ### # # # ##### ### # ####### ########### # #
# #   # # #   #   #   # # #   #   # # #   #   #   #   # # #           #       # #
### ### # # ### ####### # # ### ##### ##### ### ### ### ### # ##### ### ### #####
#   #   #   # # #   #   #   #     #     # # #   #   # #     #   #       #   #   #
# # # # # # # # # ### ### # ### ##### ### # # # ##### # ##### ####### # ##### # #
# # # #   #   # # #   # # # #     #           #   #   #   #       #   #   #   # #
# # ### # ####### ### # # ##### ### # ### ### # ### # ##### ####### # # # # ### #
# # #   #   #           #   #   #   #   #   # #     #   #   #       # # #   #   #
# ### ### # # # ######### ### ####### ####### ### ####### ####### ####### ### # #
# #   #   #   # # #   # # #   #   #   #   #   #   #   #   #       #       # # # #
# ##### ### ##### # ### ##### # # ####### # ### ### ### ######### ##### ### ### #
#   #   #   #   #   #       #   #   #   #   # #   # #   #   #   #   # # #   # # #
# ### ### # # ### ### ##### # # ####### # ### # ### ### # # # # # ### # # ### ###
# #   #   #   #   #   #   # # #   #   #       #   #   #   #   # # #   #   #   # #
### ### ### # # # # # # ### ### # # # ### # ### ### ### ### # ##### ### ### ### #
#   # # #   #   #   #   # # #   #   #   # # # # #     # #   # #     #   #   #   #
# # # ### ### ### ### ### ### # ### # ### # # # # ### # ##### ### # # # ### # # #
# #   #     # # #   # #     # # #   # # # #   #   # # #   #   #   #   #       # #
# # ####### # # ##### # ### ### ####### ### ### # # # # ### # ##### ### ### ### #
# # #   # # #   # #     #     # #   #     # # # #   # # #   # #     #   #   #   #
### # # # # # # # ### ### ####### ### ##### # # # ### ### ### ### ####### # # ###
# #   #   # # #   #   # #     #   #   #       # # # # #   #   #   #   #   # # # #
# # ### ### ### ### # # # # # ### # # ##### # ##### # ####### # # # ### ### ### #
#   #   #   #     # #   # # #     # #   #   #       #   #   # # #   # # # #     #
# ##### # # # ####### ### ### ####### ### ### ####### # # ### ### ### # # ### # #
# #   # # # #     #     # #   #   #     # #       # # #   #   #   #   # #     # #
# # # # # ##### # # # # ### ##### # ### ### ### # # ### ### # ### # ### ### ### #
# # #   #     # # # # # # # #   #   # # #   # # #   #   # # # #     # #   # # # #
# ### ### ##### ######### # # ### # # ##### # ####### # # ### # ### # # ##### # #
# #   #   #   #   # # #           #   #   #   #   #   #   # # # #     #   #   # #
### ### ### # # ### # # ####### ### # # ### # # ### # ### # ##### ### ### # # # #
#   #   #   #         # #       #   #     # #   #   #   #       #   #   #   # # #
################################################# ###############################

