########################################################### #####################
#     #       #   #   #   #   #           #   #   #       #   #   #   #     # # #
### ### # ##### ##### # ### ### ### ####### ### # ##### ### ### # ### # ##### # #
#   #   # # #   # #     # # #   #           #   #   #   #   #   #     #     #   #
# # # ##### # # # # ##### # # ####### # ### # ### ##### ### # ### # # ### ### ###
# #   # #     #   #   #       # #     #   #   #   #   #   #   #   # # #       # #
# ### # ### ### ### ####### ### ### ### ##### ####### # ####### ### ### ### # # #
# # #   #     # #   #           #   # # #   #     # #     # #   #     # #   #   #
# # # # # ### ### ### # ### ### # ### # # ######### # ##### # ### ##### # #######
# #   #     # # # #   #   # #   # # #     #       #   #   #   #   #   # # # # # #
### ##### ### # # ### ##### ### ### ### ### ####### # # ####### ### ### ### # # #
#       #   #   # #     #   #       #   #   #     # #   #   #   #       #   #   #
# ### ### ### ### ### ####### ### # # # # ### ### ### # ### # ### # ### # # # ###
# # # # # #   #       #   # #   # # # #   #   #   #   # # #   #   #   # # #   # #
# # ### ####### ### # # ### ################# ##### ### # # ### # # ####### ### #
#   #   #   #   #   #       # # #   #   #   #   #   #   # # #   # # #   #   #   #
# ### ### ### ########### ### # # ### ### # # ### ### ### # ### # ### ### ### ###
# #       #   #   #   #   #   #   #   # # #   #   #   #   # # # # #   #       # #
# # # ##### ### ### ### # # ### ### ### ### # ### ##### # # # # ### ### ##### # #
#   #       #   #   #   #   #   #   # #     #   #   # # #   #       # # #   #   #
# # ##### ### # # ####### ##### ### # ### ####### # # ### ### # ##### ##### # ###
# #   # #     #   #   #     # # #     # # #   #   # # #   #   #           #   # #
# ##### # ##### ##### ##### # # ### ### # # ##### ### # # ##### # ### # ### # # #
#     #     #   #       #   #       #   #   #   #       # #   # #   # # #   #   #
# ### ### ### ##### ######### ### ### ### # # ### ### # ##### ### ####### # ### #
# #   #   #       #           #     #     #   #   #   #   #   #     # #   #   # #
### ### ### # ##### ### ########### ####### # # ### ### ##### # ##### # ### # ###
#     # #   #       #   #   #       #   #   #   # # #   #       # #     #   # # #
# # ##### ### # ##### ##### ##### ### ##### ##### ####### ### ### ### # # ### # #
# #   # # #   #   #   #         # # #   # #   #   #       # #         # # #   # #
# ### # # # # ####### # ### ####### ### # # ### ### ### ### ### ####### ### ### #
#   # #   # #       #   #   #     #     #   #   #   #   #       #   # # #   #   #
# ### ### # ### ####### ######### # ##### # # # # ### ### ### # # ### # ##### ###
# # # #   #   #   # # #     # #       #   #   #   #   #   #   #   #     #     # #
### ### ### ### ### # # ### # # ### ### ### # # ### # # ####### ####### ### ### #
#     # #   #   #       #       #   #   # # # # #   # # #           #   #   #   #
# ### # ##### ### ### ### ####### ### ### ### ########### ### ### ### ### ### ###
# #   #   #     # # # # #     #   #   #   #   #     # # # # # # # #   # #   #   #
### ### ### ### ### ### ### # ##### # # ### ### ##### # ### ### ####### ### ### #
#   #   #     # #   #   #   # # #   #   # # #           #   #   #   #   #       #
### # ### # ##### ### # # ##### # ### ### ### ### ### ### ### ### ### ### #######
# #   #   #       #   #   #       # #         #   #   #   #   #   #       # # # #
# # ### ### ### ### ### ### ### ### ### ### # # ####### ##### ### ### ##### # # #
#     # #   # # #   #       # # #   #   #   # # #       #   #           #   #   #
# ### ####### ### # ##### ### ### # # ### # ########### # # # ### ### ### ### ###
# #   #     # #   #   #   #   #   #   #   #   #     # # # #   #   #             #
### # # ##### ### # ### # ### # ########### ### ##### # ### ### # # ### ### ### #
#   #   # #   # # # #   #     # #   #   #   #   #   #       # # # # #   #   #   #
# # # # # ### # # ### ### ### ### # # ### ##### # # # ####### ### ### # ####### #
# # # #   # #     # # #   #   #   #   #   #       #   # #     # # # # # # # # # #
# ### ##### ### # # ### ####### ##### # ### ### # ### # ### ### # # ### # # # # #
#   #   # # #   #     # #   #   #     # #   # # #   #       #   #   #       #   #
# ####### # # ### # ### # # # ### # # # # ### ####### ### ### ### ### ### ### ###
# #   #       #   # #     #     # # # #       #   #   #   #   #   #   #   #     #
# # ####### ### ### ####### ########### ### # # # # # # # # ##### ### ##### # ###
#     #     #     #   #           #       # # # #   # # #       # #       # #   #
####### #########################################################################

