############################################### #################################
#         #       # #     #   #   #   #   #     # #       #   #   #       #   # #
# ##### ### # ##### ### ### # ### # # # ### ##### # # ####### # ### ### # # ### #
#   #   #   #   #   #   #   #   #   #   #   #   #   #   #   #     # #   #   #   #
# ### ##### ##### ### # ##### # # ####### ### ### # # ### # # ### ### # ##### # #
# # # #   # #         #   # # #   #       #   #   # # # # #     # #   #   # # # #
# # ### ### ### ### ### ### ### # ##### ### ### # ##### ##### ##### ### ### ### #
#   #             # # # #   #   #       #   #   #       #   # #     # #     #   #
### # ### ### ##### # ### ### # ##### ### ### ### ####### # # ##### # ### ##### #
#     #     # #           #   #     # #   #   # # #       #     # #     # #   # #
##### # # ######### # ##### ### ### ### # # ### # # # # ####### # # ####### ### #
#     # #   #     # #   #   #   # #     #   #   # # # # #               # #     #
# ### ### ### # # ### ### # ##### ############# ### ##### ### ### ### # # ### # #
# #   #   #   # # # # #   # # # # #       #   #         # # # # # #   #   # # # #
####### # # ### # # ### ### # # # # ### ### ### ### ### ### ### ####### # # # # #
#   #   #   #   #   #   #   # # #     # #       #   #   #   #   #     # # # # # #
# # ##### # ##### ### # ##### # # ####### ### ### ### ### ### ### # ####### # ###
# #   #   #   #       #               # # #   #     # #   #   #   # # #       # #
### # # ### ### ### ### ####### ####### ### # ##### ### ### ### ##### ##### ### #
#   #   #   #     #   #     #           #   #   #       #   #   # # #       #   #
######### # # ### ### ### # ### ##### ####### # ######### ### ### # # ### # # ###
#         # #   # #     # #   #   #       #   #                   # # #   #   # #
####### ### ### ### ####### ####### ### ### # # ### ### ####### ### # ### # ### #
#   # # #     # # # #   #         #   # #   # # # # # # #   #   #       # # #   #
# # # ### ### ### # # ### # ### ####### # # ### # ### # # ### ### ### ### ### ###
# #   #   #       #   # # #   #   #       #   #   #   #   #       # # #       # #
### # # # # ### ##### # ####### ####### ##### # ### # # # # # ### # ### ### # # #
# # #   # # # # #   #   # # #   # # # # # #   # #   #   # # #   #   #   #   #   #
# ### ##### # ### ### ### # # ### # # ### ### ### ### ####### ### ### # ##### # #
#     #   #   #   #   #   #   #   #     #       # #   #   #   #   # # #   #   # #
### # # ##### ### ####### # ##### # ### ### ### ##### # ### ### ### ##### # ### #
# # #   #           #   #   #   #   #   #   # # # #     #     # #   #   # # #   #
# # ##### ### # ##### ### ### # # # # ### ### # # ### ### ####### ### # #########
#     # # #   #   #   #   #   # # # # #       #     # #       #   # # #   #     #
### ### ####### ### ### # # # # ### ### ### ############### ### ### # # ### ### #
# # #   #     #     # # #   # #     # # #   #   #   #           #   # #     #   #
# # # ### ####### ### ### ####### # # ### # # # # ########### ### ### ### ### ###
#     #   # # #   #   #   #   #   #   # # #   #           #       #   #   #   # #
### ### # # # ### # ### ### ### # # ### ### # ######### ####### ### ### ### ### #
# #     #     #   # #   #       # # #       #       # #     #   #   #   #   #   #
# # ######### ### # # ### ### ### ############### # # ####### # # # ######### # #
# #       #   #   #     # # # #     # #   #       #   #   #   #   # #     #   # #
# # # ####### ##### # ### # ### # ### # # ##### ### ### ##### ### ### # ### #####
#   #   #       #   #   # # #   #   #   #   # # # # #   #     #       # #   #   #
# ### ### ### ### # ####### ##### ### ### ### ### ### ### # ##### ### ### ### ###
# #   #   #     # #           #     # # # # #     #       #   #   #     #   # # #
### # ##### ### ####### ### ### ### # # ### ### ####### ### # # # ##### ### # # #
#   #   # # #   #   #     # # # # # #           #       #   # # #   #   # # #   #
##### ### ####### # # ### # # ### ### ##### ##### # ### ######### ### ### # # ###
#     # # #   # # # # #   #       #   #   #   #   # # #       #   # #         # #
##### # # # ### ### # # ####### ### # # # # ####### # # # ##### ### ### # ### # #
#   #   #           # #   #   # #   #   # # #   #   #   # # #       #   #   #   #
### # ### ### # # # # ### ### # # ### ### # # # # ### ### # # # # ### # # #######
# #   #     # # # # #   # # #       # #   #   # # #     # #   # # # # # # #   # #
# # # # # ### ##### ####### ### # # ### # ##### ##### ### ##### ### ### # # # # #
#   #   #   #   #       #       # #   # #   #       #   #   #   #       #   #   #
##################### ###########################################################

