################################################################### #############
# #         #       # # # #     #     # # #   #       #           #       #   # #
# # # ### ##### # ### # # # ##### ##### # # ### ### ####### ### # ### ### # ### #
#   #   #       # #         # # # #     #   #   #           #   #     # #   #   #
# ##### ##### # # ### # # # # # # ### ##### # ### ### ############# # # # ### # #
# #   # #     # # #   # # #   #       #   #   #   # # #   #   # # # # #   #   # #
# # ##### ####### # ### ####### ### # # ### ####### ### ### ### # # ####### ### #
#   #   #   #   #   # #         # # #   #   #       #   #   #   # #   # #   #   #
# # # ### # # ### # # # ##### ### ### ### # # ### # # ##### ### # # ### ### # ###
# #   #   #   #   #   #   #   #   # # #   #   #   #   #   #       #   #     # # #
### ### # # ### ### ######### ### # ### ### ### # # ##### # ### # ##### ####### #
#   #   # # #   #   #   #   #           #   #   # # #   #   #   #       #   #   #
# ##### ### # ### ##### ### # ### ####### ### # # ### ### # # ### ####### ### ###
#   #     # # # # #   #   #   #   #     #   # # # # #   # # # #   #   #   #   # #
####### # # # # # # ### ### ####### ### ### ### ### # ##### ### # # ##### # # # #
#   #   # # #   #   # #       # #   #   #   #       #         # #   # #     #   #
### # ####### # ### # ####### # ### ########### # # # ### ####### ### ### ### ###
# #   # # #   #   #   # #     #           #   # # #   #   #   #   #       #   # #
# # # # # # ########### ##### # ### ####### ### ### # ##### ### ### # # ### ### #
#   #     # #   #   #   #       #   # # #   #   #   #       # #     # # #   #   #
# ### ### ### ### ### ######### # # # # # ### # ##### ### ### ### ### ####### # #
# #   #   #   #   #   #   #   # # #   #   #   # #       #     # # #   #       # #
### ### # # ### ### ##### # ### ### # # ### ####### ########### ### ### # ##### #
#   #   #   #   #   #   # # #   #   #   #   # # # #     #   #           #   # # #
# ### ##### ### # ##### # # ### ### ##### # # # # ### # # ########### ### # # ###
#   # #   #       #   #       #   #   #   #   #   #   #   #             # #     #
### # # # # ### # # ### ####### ### ### ### # # # # ####### ### ### # ##### #####
#   #   # # #   #       #   #   #     # #   #   # # #     # # # #   #   #   #   #
# # # # ### # ### ### ### ### # ### # ####### # # ### ### ### ### # # ####### ###
# # # # #   # #     # #   #   # # # #     #   # #     #   # #     # # #   #   # #
####### ### ### ### ### # # ##### # # ##### ### # ##### ### ### # # # # # # # # #
#   #     # # # # #     # # # #     #     # # # #   #   #   #   # # #   #   #   #
# ### # ##### # # ### ####### # ##### # ##### ### ####### ### # # ##### ##### # #
#     #   #   #   #       #   # #     #   #   #   #   #       # #     # #     # #
# ##### ##### ##### ##### # ### ######### # ### ### ### # # ### ####### ####### #
# #   # #   #   #   #   #     # #   # #       #       # # # #       #         # #
# ### ### # # ### # # # ### ##### ### ####### # ##### ####### ##### # ### # # ###
# #       #       #   #   #   #   #   # # # # #   #     #     #   # # #   # #   #
##### ### ##### ####### ### ### ##### # # # ####### ### ##### # # ##### ####### #
# #   #     #   #   # # #         # #   #   #   #   # # # #     #   # # # #     #
# ### ### ##### # # # ### # # # # # # ### ### ####### # # ### ### ### # # ##### #
#     #   #   #   #   #   # # # #     #   #   #   #       #   #   #   #   # # # #
# ##### ### # # # ### # # ##### ####### # # # # # # ####### # ### # ### ### # # #
#   #   #   #   #   # # #   #           #   # # # # #   #   # #     # # #       #
##### ####### ### ### ### ### # ##### # # ### ### # # ### # ##### # # ##### ### #
# #   #   #   # # #   #     # #   #   # # # #     #   #   #   # # #   #   # # # #
# # ### ### ### ####### ### ### ### ##### # ### ### ##### ##### ### ##### ### # #
#       #   #     #     #   #   #     #   #     # # #       #   # # # # # # #   #
# ### ### # # ########### ### ### ####### ####### ### ### ### ### ### # # # # ###
# #   #   #           #   #   #   #   #   #   #         #     #   #   #   #     #
### ### # # ### # ### ##### ### # # ### ##### # ### ### ### ### # # # ### # ### #
# # #   # # #   # # #   #   # # #   #   #   #   #   # # #   #   #   #       #   #
# # ### ### ####### # # # # # ### ### # ### # ### # # ### ### ####### ### ### # #
#     #   #   #     # # # #   #   #   #   #   #   #   # # # #     #   #   #   # #
### ####### # # # # ### ####### ##### # ### ### # ### # # # # ### # # ##### #####
#       #   #   # # #   #       #     # #   #   #   # #     #   # # #   #       #
################### #############################################################

