################################# ###############################################
# # #       # #       #       #   #               #   #     # #   #         #   #
# # # ##### # # ### # # ##### ### # ############# # # # # ### # # # # ### ### # #
# #   #       #   # # #     #     #     # # #     # #   #   #   #   # # # #   # #
# ####### # ### ### # ##### ##### ##### # # ##### # ### # ### ####### # # ##### #
#   #   # #   # # # # #   #     #     #         # #   # # #   #       # # #   # #
# # # ### # # # # # ### # # ### ############### # ##### # ##### ####### # # # # #
# # #     # #   #   #   #   #   # #             #       #     #       #     #   #
# # # ##### ##### ### # ### # ### # ############# ########### ####### # ####### #
# # #     #     #     #   # #     # # #   #       #     #   #         #       # #
# ####### # ########### # ### ### # # # # # # ##### ### # # ### ######### # ### #
# #       # #       #   #   #   # # # # #   # #     #   # #   #   #       # #   #
# # ##### # ### # ### ##### ### ### # # ##### ####### ### # ### # ### ##### ### #
# # #     # # # #   # #     # #       #     #   #   # #   # #   # # # #   #   # #
# # # ####### # ### ### ##### ############# ### # # # ### ### # ### ### # ##### #
# # #   #   #   #   # # #     #     #       # #   # #   #     # #     # #     # #
# # ##### # # ### ### # ##### # ##### # ### # ##### # # # # ##### ### # # ### # #
# #       #   # #   #   #     #   #   # # # #   # # # # # #       # # # #   # # #
# # ####### ### # # # # # ####### ### # # ### # # # ### ######### # ### ### # # #
#   #     # #   # # # # #   #   #   # # #     # # # #   #     #   #   #   # #   #
# ##### # ### ##### # # # # # ### # ### # # ### # # # ### ##### ##### ### # #####
#       # #   #   # # # # #   #   #     # # # # # #   # #           #   # #     #
# ####### ### ### # # ### ##### ########### # # # # ### # ######### # ### ##### #
# #     #   # #     #       #   #         # # # # #     #   #   # # #   #   #   #
### ### # ### # ##### ##### # ### ##### # # # ### ### ##### # # # ##### ### #####
#     # #   # #   #   #     # #   #   # # #     #   # #   #   # # #       #     #
# ##### ### # ### ##### ##### # ##### ### # ### # # # # # ####### # ########### #
#     #     #       #     #         # # #     # # # #   #     #   #         #   #
### ######### ### ####### ######### # # ####### ### ######### # ######### ### ###
#   #   # #     # #     #   #     # #         #   #   #     #   #     # #     # #
# ### ### # # # ### ### # ### ##### ### ##### ####### # ### ##### ### # ####### #
#       # # # # #   #   #   #   #     #   # # #   # #   # #       #   #         #
# ####### # # # ### # ##### # # ### ##### # # # # # ##### ######### ### ### # ###
# # #   #   # # # # #     #   # # # #     # # # #   # #             #     # #   #
# # # # ####### # # ##### ### # # ### ##### # # ### # # ################### # ###
# # # #   # #   # # # #     # #   #   #     #     #   #     # # # # #     # # # #
# # # ### # # ### # # # ##### ##### # ##### ##### ##### ### # # # # # ### # ### #
# # # # # # #     # #       #       #     #     #     #   # #     # # #     #   #
### # # # # ### ### ####### ### ### ##### # ### ##### # # # ### # # # # ### # ###
#     # # #   #   #     # # # #   #   # # # #   #   # # # #     #   # # #   #   #
# ##### # # ##### ##### # # # ### # # # # # # ### ### # # ######### # ### ### # #
#     #           #       # #     # #   #   # #   #   # # #         #   #     # #
##### ################# ### # # ####### ##### # ### ### # # # ######### #########
#   # #   #       # #   #   # # #   #   #   #   #   #   # # # #     #   #   #   #
### # # # # ##### # # ### ##### # # # ### # ### # ####### # ### # # # # # # # # #
#   # # # #   #   #   #   #   #   # # #   #   # # #       #   # # # # # # #   # #
# ### # # # ##### # ##### # # # # ### ####### # # # # ####### ### # # ### ##### #
# #   # # # #   # # #   #   #   # #     #   #   # # # #     #     # # #   # #   #
# # ### # # # # # ### ################# # ### ### ### # # # ####### # # ### # ###
# # # # # # # # #             #     #   # #   #   #   # # #         # #   # #   #
# # # # # ##### # ##### ##### # ### # ### ##### ### # ### # ######### ### # ### #
#   #   #       #   # # # #       # #   #       #   #   # # # #               # #
##### ####### ##### # ### ######### # ##### ########### ### # # ######### ##### #
#           # #   # #       # #     #   # # #   #     #   # #   # #     # #   # #
# ##### ##### # # # # # ### # # ##### ### # # # # ### ### # ##### # ### ### # # #
#   #   #       #     # #     #           #   #   #       #         #       #   #
########### #####################################################################

