######################################### #######################################
#   #     #       #       #                       #       # #     #     #       #
# # # ### # ##### # ##### ### ################# # ##### # # # # # # ### # ### ###
# #   #   # # #     #   #     #               # #     # # #   # #     # # # #   #
# # ##### # # # ####### ####### ####### ##### ####### ### # ######### # # # ### #
# # #   # # # #   #       #   #     #   #   # #     #   # #   #     # # #     # #
### # # # # # ### # ##### # ### ##### ### # # # ### ### # ### # # # ### ##### # #
#   # # #   #   # # #   # #     #     #   # # # # # # #   #   # # #   #       # #
# ### # ####### # # # # # ### ### ##### # ### # # # # ### # # # ##### ######### #
# #   # #   #   # # # # # #   #   #     # #   # #   #     # # #     #   #     # #
# ### # # # ### # # # # # ##### ### ##### # ### ### ######### ##### ### # ##### #
#     #   #   # #   # # # #   # #   #   #   #     # #   #   #   # # # #   #     #
# ########### # ##### # # # # # # # ### ######### # # # # # # # # # # # # # ### #
#       #   # #       # #   # # # # #   #     #   # # #   # # #   # # # # # # # #
######### # # ####### # ####### # # # # ### # # ### # ##### ####### # # # # # # #
#       # # #   #     #     #   # # # #   # # # #   #   #         # # # # # # # #
# ##### # # ### # ######### # ### # # ### # # # ### ### ######### # # # # # # # #
# #   #   #     #   #     # #   # #   # # # #     #     #   #     # #   # #   # #
# # # ############# # # # # ### # ##### # ####### ####### # ### ### # ####### # #
#   # #   #   #     # # #   # # #     #   #       #   #   #   # # # #   #   # # #
# ##### # # ### ##### # ### # # ##### ### # ####### # # ##### # # # ### # # # # #
# #     # #     #   # # #   #   #   # #   #         #   #     # #   #     # # # #
# # ##### ##### # # ### # ### ### # ### ######### ####### ##### # ### ##### ### #
#     # # #   #   # #   # #   #   #   #     #   # #     #     # #   # #   # #   #
##### # # # # ### ### ### # ### ##### ##### # # # # ######### ##### # # # # # ###
#   #   # # #   # #   #   # #       #   #   # # # #         # #   # #   # # #   #
# # ##### # # # ### ### # # ######### # ##### # # ######### # # # # ##### # ### #
# # #     # # #     #   # #       #   # #     # #           #   #   # #   # #   #
# # # # # # ######### ### ####### # ### # ##### ################### # # ### # ###
# #   # # #     #       #         # # #       #     #         #     #   #   #   #
# ####### ### # ################# # # ########### ### # ####### ##### ### ##### #
# #     #   # #     #     #   #   #   # #         #   # #   #   # #   #   #   # #
# # ### # ### ##### # ### # # # ##### # # ######### ### # # # ### # ####### # # #
# # #   #     #   #   # #   # # #   #   # #   #   # #   # # #   # #         #   #
# # # ####### # # ##### ### # ### # ### # ### # ### # ### # # # # ###############
# # #   #     # #   #     # # #   # #   #   #       # #   #   # #     #         #
# # # # ####### ### # ##### # # ### # ##### ######### # ######### ### # ### ### #
# # # # #     # #   # #   # #   # #   #     #     # #   #         #   #   # # # #
# # ### # ### # # ### # # # ### # ##### ####### # # # # ######### ####### # # # #
# #   # #   #   #     # # #   #   # #   #       #   # #     #   #   #     # # # #
# ### # ### ######### ### ### ##### # ### # ######### ##### # # ### # ##### # # #
# #   # #   #       #       # #     # #   #         #   #   # #     #     # #   #
# # ### # ### ##### ####### # ##### # # ########### ### # ### ##### ####### #####
#   #   #   # #       # #   # #   # #   #   # #   #   # # #     # # #   #       #
##### ### # # # ##### # # ### # # # ##### # # # # # # ### # ### # # # # # #######
# #   #   #   # #     #   #     # #       # #   # # #   # #   #   # # #         #
# # ### ####### # ##### ########### ####### ##### # ### # ### ##### ####### ### #
# #     #     # # # #   #       #   #   #   #     #   # #   # #   # #     #   # #
# ####### ### ### # # ### # ### # ### ### # # ####### # ### # # # # # ### ##### #
#         # #   #   #     #   # # #     # # # #     # #     # # # #   # #       #
##### ##### ### ############### # # ### # # # # ### # ####### ### # ### ####### #
#   #     #   #                 # # #   # # # # #     #     #   # #   #     #   #
# ####### ### ################# ### # # # # # # ######### ##### # ### # # ### ###
# #     #   #       #     #   #     # # # # # #   #     # #   # #   # # # #   # #
# # # ##### ####### # ### # # ##### # ### # # # # # ### # # # # # # # # ### # # #
#   #               #   #   #       #     #   # #   #       #   # #   #     #   #
############# ###################################################################

