### #############################################################################
#   #     #     #             #         #     #           #       #   #         #
# ### ### # ### # # ### ##### # # ##### # ### # ######### # # ### # # # ####### #
# #     #       # #     #     # #       #     #     #       # #   # # # #     # #
# # ### ######### ####### ##### ##### ####### # ### # ### ### # # # # # # ### # #
# #             # #         #   #   # #       # #   #   # #   # # # # # #       #
# ############# # # ##### # # # # # # # # ##### # ##### # # ### # # # # ####### #
#     #       #   # #   # #   #   # #   # #     #         # #   # # # #       # #
##### # ### # ### # # # # ####### # # ### # ############### # # # # # # ##### # #
#     #     #     #   # #       #   # #   #       #   #   # # # #   #   #     # #
# ########### ######### ### ### ##### # # ####### # # # # # # # ### ##### ### # #
#             #     #     #   # #       #       #   #   # #   # #   #   #     # #
# ############# ### # ### ### # # ############# ##### ### ### # # ### # ####### #
# #   #     #   #   #           # #           # #     #     # # # #   #         #
# # # # ### # ### ####### ####### # ######### # # ##### ### # # # # ######### ###
#   #   #   #   # #     # #       # #         # # #           #   #         #   #
######### # # # # # # # # # # ##### # # ####### # # ############### ####### ### #
#   #   # # # #   # # #   # #     # # #     #     #       #       # #     # #   #
# # # # # # # ##### # ### # ##### # # ##### # ####### ### # ##### # # ### # # ###
# #   #   #       # # #   #       # # #     #       #       #       #   # # #   #
# ########### ### # # # ########### # # # ######### ##### ### ### ### # # # ### #
#     #     #     #   # #         #   # # #   #     #   #     #   #   #   #     #
##### # # # ##### ##### # # ##### ##### # # # # # ### # ####### ### #############
#   #   # # #   #   #   # # #   #   #   #   # # # #   # #     #         #       #
# # ##### # # # ### # # # # # # ### # ####### # # # # # # ### ######### # ##### #
# # #     #   #   # # #   #   # #   #   #       # # # # #   # #   #       #   # #
# # # ########### # # ####### # # # # # # ### ### # # # # # # # # # ####### # # #
# # #   #         # # #     #   # # # # #     #   # #   # # # # # # #   #   # # #
# # # # # ### ##### # # ### ##### # # # ####### ### # ### # # # # # # # # ### # #
# # # # # #   #       #   #         # # #         # #     #   # # #   #       # #
# # # # # # ### ######### ########### # # # ### # # ##### # ### # ####### ##### #
# #     #   #   #       # #         # #   #     # #     # #     # #       #   # #
# ######### # # # ##### # # ####### # ########### # ### # ### ### # ### ### # # #
#         # # # # #       #   #   # #           # #     #   # #   #   # #   #   #
######### # # # # # ### # ### # # # ######### # # ##### ### # # ##### # # ##### #
#   #   #   #   #       # #   # #   #         #       #     # # #     # #       #
# # # # # ############### # # # # ### ##### ######### ####### # # ##### ##### ###
# #   # #       #       #   # # # #   #   # #     #     #   # # #       #   #   #
# ##### ####### # ##### ### # # # # # # # # # # # # ### # # # # # ####### # ### #
#     # #   #   # #       # # # # # # # # #   # # #     # #   # #       # #   # #
##### # # # # # # # ##### # # # # # # # # ### # # ####### ### # ####### # # # # #
#   #   # #   # # #     # # # # # #     #     #   #       #   #         # # # # #
# # ### # ### # # ##### # # # # # ################# ##### # ############# # # # #
# #     #     # # #     # # #   #       #     #     #   # # #   #     #     #   #
# ##### # ##### # # # ### # ### ##### # # # # # # ### # # # # # # ### # ####### #
#     #   #     #   # #   # #   #     #   # #   # #   # #   # # #     # #     # #
# ### ##### ####### # # ### # ### ######### # ### # ### ##### # ### ### # ### # #
#   # #     #     # # #       #     #       #     #   # #   #     #       #   # #
### # # ##### ### # # # ####### ### # ############# # # # # ##### ######### # # #
#   #   #     #   # # # #       #   #     #     #   # #   #     #     #     # # #
# ##### # ##### # # # # # ### ### ####### # ### # ### ##### ### # ### # ### # # #
# #   # # #     # # #   #   #   #       # # #   # #   #   # #   #   #     #     #
# # # # # # ##### # ### ### ### # ### # # # # # # # ### # # # ##### ##### #######
# # # # #   #     #   #   #   # # #   # # #   # # # #   # # #       #   #       #
# # # # # ### # ### # ### ### # # # ### # ##### # # # # # # ### # ### # ####### #
#   #   #     #     #         #   #     #       #     #   #     #     #         #
######################### #######################################################

