############################################################### #################
#       #   # #             #   #       #     # # # # #           # #   #       #
##### ### # # ### ####### ### ### ### ##### ### # # # # # ### ##### # # ### ### #
#     # # #           # #     #     #   #               # # # #       #     #   #
### ### ### ########### # ##### ### ####### ####### ### ### ### ##### ### #######
#   #     #   # #     #     # # #   #     #     #   #   # # #   #   #   #   #   #
### # ##### # # # ### # # ### # ####### ##### ### ### ### # ### ### ##### ### ###
#     #     #   #   # # #   # #   #         # #   # #     #       # # #         #
### ####### ##### ##### ##### # # # # ### ##### ### ##### ### ##### # ### ### ###
#       # # #     # #           # # #   #   #   # #     # #         #     #     #
##### # # # # # ### # ##### ####### ##### ##### # # ### ### ##### ######### #####
#     #   # # #   #   #             #     #     # # #       # # #     # #       #
### ### ##### # ##### ##### ##### ##### # # # ### # ####### # # # ### # ####### #
# # # #     # #         #     # #   #   # # #   #   #       #   # #           # #
# ### # ### # ### ### ### ##### ### ### # # ### ### ### ##### ##### # ######### #
#   #   # # #   #   # #     #     #   # # #   #     #   # # #       # #     #   #
### ### # # # ########### ### # ##### ### ####### ##### # # ############### #####
#     # #     #     #         # # # # #     # #   #   #     #   #     #       # #
### # ##### # ### ### ### ####### # # # # # # # ##### ##### # ### ### # ##### # #
# # #   #   # # #     #   #     #   # # # #   #       # # # #   #   # #     #   #
# # ### ### # # ##### ##### # ### ##### ### ### # # ### # ##### ### ######### # #
#     #     # #       # # # # # #     #   #   # # #       #   # # #       # # # #
# ######### ### # ##### # # ### # ### ####### ##### ### # # ### # # ### # # # # #
# #       #   # #     #   # #   # # #     #       # #   #         # #   #     # #
### ##### ############# ### # ##### ### # ### ######### ####### ##### ####### ###
#     #   #       #   #   #         # # # #   #   # #     # #     #   #   #     #
# # ### ##### # ### ### # ####### ### # # # ### # # # ### # ##### ### # # # # # #
# # #       # #   # #   # # # #       # #     # # #     #   #     #     # # # # #
### # ### # # ### # ### ### # ##### ### ##### ### ######### ##### # ### ##### # #
#   # #   #     # # # #       #   # # #   #   #       #       # #   # #   #   # #
# ####### ####### # # # # ##### # # # # # ######### ### ##### # # ### # ####### #
# #   #   #     # #   # # #     # # # # #     #   # # #   # # #     #       # # #
### # ### # ### # ### # ####### # # # # ##### # # # # # # # # ########### ### ###
#   # #   # # # # # #           #   # # #   #   #   # # #   # #   #     #     # #
# # ### # # # ### # ### # # # # ### # # # ####### # # # ##### # ### ######### # #
# #     # #             # # # # # # #     #       # # #   #     #   # #       # #
####### ####### ##### ### # ##### # ##### ##### # # # ##### ### ### # ######### #
#       # # # # # # #   # # # #         #     # # #     # # #   #   # #   # # # #
# ####### # # ### # ##### ### # # ########### ####### ### ### ##### # # # # # # #
#   #   #       # #         #   #         #       #           #     #   # # #   #
# ### # ##### ### # ### ### ##### ### ### # ####### ##### ####### ### ### # # # #
#     #   #     #   #     #     # #   # # #   #   # #       # # #       #   # # #
# ### ##### ##### ### # ### ### # ### # # ##### # # ##### ### # # # ### ### # ###
# #   #       # #   # # # # #   #   #   #   # # # #   # # # #   # #   #   # #   #
### # # ### # # ### # # # ######### ### ##### # ### ### # # ### # ####### # ### #
#   #   #   # #     # #       # # #   # #     #       # # #   #   # #     # #   #
# ### ##### ####### ######### # # # ### ### ########### # # ##### # ### ##### # #
# #   # # # #             # #     # #           # #   #       # # #     #     # #
# ### # # # # ####### # # # ####### ############# # # # ### ### ### # # # #######
#   #   # # #     # # # #       #       #         # # # #     # #   # # #   # # #
# ####### ### # ### ##### ### ######### # ##### ### ### # ### # # # ### # ### # #
#       #     # #     #   #     #   # #   #             # #   # # # #   #       #
### ### # ##### ##### # ####### ### # # # # ### ####### ### # # ####### ### #####
#   #   # #     #           # #       # # # # #   #   # #   #   #       #       #
# # # ### ######### # ### ### ### ### ####### ####### # ### ##### ##### ##### ###
# # #   #       #   # #       #   #               #     #           #           #
######################################### #######################################

