############################################################################# ###
#     #     #           #           #   # #     # #       #       # #     #     #
##### ##### ### ####### # ####### ### ### # ##### # ### ##### # ### # # ### ### #
#     #     #   # #   #     #     #             #     #   #   #   # # #     # # #
### ####### ### # # ### ### ############# ############### ### ##### ### # ### # #
# #       # #   # # #   # #       #   #       # #       # #   #   # #   # #   # #
# ##### # # ##### # ##### # ######### # # ### # # ##### # ### # ### ### ### # ###
# #   # #     #             #   #       #   #   #   # # #   #         #     # # #
# # ####### # ### ### ### ### # # ### ##### # # # ### ##### ##### ### ### # ### #
#   #     # #     #     # #   # #   # # # # # #   #         #     #   #   #     #
# ##### # # ##### # ### ##### ##### # # # ########### ### # # ### ##### ### ### #
# # #   # # #     # #   #   #   #   # # # # # #         # #     #   #   #   # # #
# # ##### ### ### ### ### ##### # # ### # # # # ##### ####### # ### # ### ### # #
#     #         # #       #     # #     # #       #     #   # #   #   #     #   #
# # # ####### ######### ####### ### ##### # ##### ####### ################# #####
# # # #   #   # #   #               #     #   #   #             #   # #         #
# ### # ### ### # ### ### ##### ##### # # # ### ### ##### # ### # # # # # #######
#   #     #   #   #   #   #   #       # #     #   # # #   #   # # #   # #   #   #
# ### # # ##### # ######### ##### ########### ### # # ##### ##### ### ######### #
# #   # #   #   #   #   #   # #         #     #     # #   #   #     # # # #     #
# ### # # # # ####### ### # # ##### # ########### ### # ####### ##### # # ### # #
#   # # # #     #     # # #       # #       # #   #   #   #     # # #         # #
# ######### # ### # # # ### ######### # ### # # ##### # # # ### # # # ### #######
# #     # # #   # # #     #         # # # # # # #       #     #     # #       # #
# ### ### # ### ####### # # ### ### # ### ### ####### ############# # ##### # # #
#   #   #   #         # #   # # #   #     # #     #     #   #   #   #   #   # # #
# ### # # # ### ### ### ##### # ####### # # # ### ##### # # # ##### # # ##### # #
#   # # # #   # #     #   # #   # #   # #   # # # #     # # #   #   # #   #   # #
### ### ### ### ### ##### # ##### # # ### # # # ##### # # ### # ### ####### ### #
#       #     #   #   #     #     # #     #         # # #     # # #   #       # #
### # # ##### ######### ####### ### # ######### ##### # # # ##### # # ### ### # #
#   # #   #     #       #   #   # # #   #           # # # #   #   # #   # # # # #
# # ### # ##### ##### ### ### # # ### ### ####### # ### ##### ### ### # ### # # #
# #   # #   # #       #   # # #     # # #     #   # #   # # #         #     # # #
# ### ####### ### ##### # # # # # ##### # ####### ### # # # # ##### ########### #
#   #     #         #   #     # # #         #       # #   #       # #   # #     #
####### # ######### # # # ##### ### ########### ### ### ### ### ##### ### ##### #
#   # # #   #     #   # # #   #   #   #   # # # #   # #   # # #         #   # # #
# # # ##### # # # ##### ### # # ### ### ### # # # # # # # ### # ##### ##### # # #
# #   # # #   # # #   #   # #     #   #     #   # #   # #   #   # #   #     # # #
### ### # ##### # # ### ### ##### # # ### # ### # # # # # ### # # # ### # # # # #
# #             # #       # # #   # # # # #     # # # # # # # # #   #   # #     #
# # # # ##################### ####### # ####### ### ### ### ### # ##### ### ### #
#   # # #   #   #   # #   #       #     #   # # #     #   # #   # # #     #   # #
### # ##### # # # ### # # ####### # ##### ### ####### # # # ### # # ####### ### #
# # # #   # # #   # #   # #   #       # # # #   #   #   # #   # #       #   # # #
# # ##### # ### # # # ##### # ####### # # # ### # # # # # ### ############### # #
# #   #     #   # #         #                 #   # # # #   #   # #     #   #   #
# ### ### ##### ### # # ### ######### ### ######### # ### # # ### # ##### ### ###
#     # # # #     # # # #   #         #             # # # #     #   #     #     #
### # # # # # ##### # # ### # ##### ######### # ### ### ##### ### # ##### # ### #
#   #               # # #   # #     #       # #   #   #           #         # # #
### ##### # ##### # # ### ### # ### ##### ### ### # ##### ### ### # ##### # # # #
#       # #   #   # # #   #   #   #     #       # #     # #     # #   #   #   # #
########################################################### #####################

