##################### ###########################################################
#             #     #   #       # #       #   #   #             # #       #     #
##### # ##### # ### ### # # # ### # ####### ##### # ##### ##### # # ### ### # ###
#     #     #   #     #   # # #   #         # #   # #   #   #   #   #       # # #
### ### ##### ##### ### ##### # ### # ##### # # ##### ####### # ####### ####### #
#   #       # #     #   # #   #   # #   #     #   #       # # #         # #     #
##### # # ### # # ### # # # # ### ### # ######### ##### ### ##### # ##### # ### #
#   # # # # # # #     # #   #         #   #   #               #   # #       #   #
# # # # ### # ####### ##### # ### ####### ### ### ####### ### ### ### ####### ###
# # # #   #     #   # # #   # # # # # #       #   #   #   #   #   # #   # # #   #
### ### ### ### ### ### ### ### ### # # ####### # # ######### # ### # ### # ### #
#     #   #   #   #     #   # # #         #     # # #   # #     #       # # #   #
##### # # ####### # ### ##### # ### # ##### ####### # # # ### ### # # # # # #####
# #     #   #     # # #   #         # # # # # #   #   # #   #   # # # # #       #
# # # ### # ##### # # ##### # # ####### # ### # # ##### # ##### ### ##### ### # #
# # # #   # #     # # # # # # #   #     #       #       #   # # # #   #   # # # #
# ####### ##### ### # # # ##### ### ##### ####### ### ### ### # # # # ### # # ###
#   #     # #       #   # #     #       #     # # # #     #   #     #     #   # #
### # ### # ####### ### # ### ### # # ### ### # # # ####### # ##### ####### ### #
#     # #   # #       #   #     # # # #   # # # #     #   # # #     # # #       #
# ### # ### # # ### # # ####### # # # ### # ### ### ### ### ### ### # # # #######
#   #     # # #   # # #         # # #     # #   # #     #   #     # #     # # # #
######### ### ### ########### ########### # # ### ### ### ##### # ### ### # # # #
#     #     # # #     #   # # #       # #     # # #   #   #   # # #     #       #
##### ##### # # # ##### ### ####### # # # # ### # ### # ##### ##### ####### ### #
#     #   #   #       #         # # #     #     #     #     #   #   # #       # #
##### ### # ### ### ### # ##### # # ##### ### ### # ##### # ### # ### ### # # ###
#     #   #   # # #   # #     # #   #   # # # #   # #     #       # #   # # #   #
### # # ######### # ######### ### ##### # # ##### # # ############# ### ### #####
#   #       #     #       # # # # #     #     # # #     #     #   #     # #     #
# ##### # ### # # ### # # # # # # # ##### ##### ####### # ##### ### ##### ### ###
# #     # #   # # #   # # #       # #         #         # # #           #     # #
##### ####### # ######### # ### ### # # # # ######### # # # # ### ### # # ##### #
#     #   # # #     #   #   #   #     # # # # #   # # # #     #   #   # # #     #
# # # # # # ####### ### # # ### ### ####### # # # # # ##### ### # ##### # # #####
# # # # #   # #     #     # # # #     #   #   # # #   #     #   #     # #   #   #
# ##### ##### ##### ##### # # # # # # # # ### ### ### # ### ##### ######### # ###
#   #   # #             # # #   # # # # #   #   #   #   #     #         #       #
### ### # # ### ######### ### ##### # # ######### ##### # ### ######### ### #####
#     #     # #   # # #     #   # # #   #     # #   # # # # # #   # # # # #     #
# ### ### # # ### # # # ### ##### # # ####### # # ### ##### # # ### # # # #######
# # # #   #     #     # # #     # # #             #   # #   #   # # #           #
### # # ##### # # ### ### ##### # # ########### ### ### # ####### # # ### ### # #
#         #   # # #   #         # #     #   # #   #       # #     #     # #   # #
### # ##### ### ##### ##### ### # ######### # # # # ##### # ### ############# # #
#   # #     # #     #   #   #     # #     #     # # #   #   # #               # #
# # # # ### # ##### # # ##### ##### # ### # # # ### # ##### # ##### ##### # # # #
# # # #   # # #     # #         # # # #   # # #         #   #   #     # # # # # #
##### ####### ##### ############# # # # ##### ##### # ### ### ######### ### # ###
# #           #         # #   #     # # #   #   #   # # #     # #     # #   # # #
# # # # ##### ##### # ### ### ### ### ### # ######### # ### ### ##### # ##### # #
#   # #   # # # #   #                     #   # #       #       # #       #     #
# # ####### # # # ### ### ### # ######### # ### # ### ##### ### # ### ####### ###
# #   #         # #     # #   #       #   #   #   #   #       #     #           #
########################### #####################################################

