################################################################### #############
#         # #   # #   #       #     #     #         # # #       #   #   #     # #
# ### ##### ### # ### # # ### # ##### # # ### ####### # ### # # ### # # ### # # #
#   # #         # # #   # # #     #   # # #       #   # #   # #   # # #     # # #
### ##### ### # # # ####### ### # ##### # # ### # # # # ####### ### ##### # ### #
# #     #   # #       # #       #   #   # # #   #   # #   # #     #     # #     #
# ### # # ### ######### ### ### ######### ### ########### # ##### ### ### # #####
# #   #     #   #   # #   # #     #         #     #                       #   # #
# # ##### ##### # ### # ######### # ############# ##### ####### # ### ##### ### #
#   #         # #       #     #           #   # # # #         # #   # # #   #   #
########### ### # # ######### ### # ### ##### # # # ####### ######### # # ### # #
#   #     # #     #     # # # #   #   #         #   #     #   # # #     #     # #
# # # ### ### # ##### ### # # ########### # # ### # ##### # ### # # ### ####### #
# # # # #   # #     # #     # # #     #   # #     # #   # #       # #         # #
# ### # # ##### ### # # # ### # # ### ### # ######### # # ##### ### ##### # # # #
#       #   # #   # #   # #     # # #     #       #   #     #   # # #     # # # #
# ##### ##### ##### ### # ##### ### ### # ##### ##### # ##### ### # # ####### # #
#     #   #           # #   # #   #   # # #   #       # #   # #   # # #     # # #
##### # # # ### ### ######### # # ### # ### ##### ##### # # ##### # # # # ### ###
# #   # # # # # # #   #   # #   #       #     #   #   #   #   #   # #   # #     #
# # # ### # # # # ### ### # # ##### ######### ### # ### ### ### ### # ######### #
#   # # # # # # #             #         # #   #     # #   #   #     #     #   # #
# ### # # # # # ### # # ####### ####### # # ### # # # ##### ### ####### # # # ###
#   # #       #   # # # #   # #   #       #   # # #       #     #   #   #   #   #
# ### # ####### # ##### # ### # # # ### ### ### ##### ### ### ### ######### # ###
# #   #       # #   #   # #     # # # #     #   # # # #     # #   # #     # #   #
##### # # ##### ### ##### ####### ### ##### # ### # # ### ##### # # # ### # ### #
#     # #   #   #   #   #         #   #   # #     #     #   #   #   # # #     # #
# # ##### ### ####### # ### # ##### ##### # # ####### # # # # ### # ### ##### # #
# # #     #   # #   # #     # # #         # #   #   # # # #     # # # # # #   # #
# ##### ####### ### ####### # # # # # ##### ####### ### # # # ##### # # # # ### #
#   #   #   #       #       #     # # #   #       # # # # # #     # #   # # #   #
# # ### # ######### ### ### ############# # ##### # # # ############# ### # ### #
# #   #   #       #   #   # # #       #     #       # # # #   #   #   #       # #
### # ####### ### ### # # # # # ### # # ############# ### ### # # # # ######### #
#   #   # #   #       # # # # # #   # #       #       # # #   # #   #     #     #
# # ##### # ######### ### ### # # ### ####### # ##### # # # # ####### ### # #####
# # # # #   # #   #   #         #   #   #     #   #       # #       # # #   # # #
# # # # ### # ### # ##### ############# # ### # ##### # # ####### ##### ### # # #
# #               # #     #     #     # #   # # # # # # #   # #         #     # #
# # ############# # ### ### # ##### # ##### # # # # # ####### ##### ### # ### # #
# # # # #   #     #   #     # #     #     # #   # #     # # #         # #   #   #
### # # # ### ### # ##### # # ####### # # # ##### ##### # # ### ##### ######### #
#       #       # #   # # # # #   #   # # # # #     #       #   # #   # #       #
### ##### # ### # ### # ##### ### ####### ### ### # # ##### ### # ##### ##### ###
#     #   # #   # #   # #     #     #       #   # #   #   #   #       #     #   #
# ### # # # ### ####### ### ####### ### ### # ### ### # ### # ### ### # # ### # #
#   # # # #   # #   # # #   #       #   #         # # # #   #   # #     #   # # #
# # # ######### # ### # # # ##### ### ### # # ### # # # ####### # ####### #######
# # # #       # # # # # # #   #     #   # # # # # #     #   #           #       #
# # # ##### ### # # # # ##### # ##### ### ### # # ####### # ### ##### ### ##### #
# # #       #       #           #   #   # # #   #   #   # # #     #     # #   # #
# ##### # # # # ### ##### ##### ### # ##### # # # ##### # ### ##### # ### # ### #
# #     # # # #   #     # #       #         # # # #           #     # #       # #
########################################################################### #####

