##################################################################### ###########
#       #       # # # #       # #         # #     # # #     # #       #     # # #
# ######### ##### # # # ##### # # ####### # ##### # # ### # # ####### # ### # # #
# #     #           # # #   #     # #     # #       # #   #       #     #   #   #
# # ####### ##### ### # ### # # ### # ### # # # ##### # ##### ### ### ##### # # #
#   #       #   # #     # # # # #   # #       # #     # #     #   # #   #     # #
### ### ### # ### ##### # # ####### ##### ### # ### # # ####### # # # # # ##### #
#   #   #   #   #   # #   # #           # #   # #   # # #       #   # # #   #   #
### # ####### ### ### ##### # ##### ##### # ### # ################# ##### # # # #
#       #   #     #             # #   # # #   # #               #   # #   # # # #
### ##### ### # # # # # # ####### # # # # # ####### ##### ### ##### # ### # # # #
# #     #   # # #   # # #     #     #   # # # #       #     # #       #   # # # #
# ### ##### ##### ##### ### # ####### # ### # # ### # ### # # ##### # # ##### # #
#     # #   #   #     #   # # #     # # #     #   # #   # # #       #       # # #
####### ### ### # ### ### ######### # ### ### # ##### # # ########### ##### # ###
# # # # # #     # #   # #   # #     #   # #     # # # # # # # # #         # # # #
# # # # # ### ##### # # ##### ### # # # ######### # # # ### # # ### ### # # # # #
#   # #   #         # #     #     #   # #   #       # # # #         #   # # #   #
# ### ### # ### ### ### ### # ### # # ### # ####### # # # ####### # ##### # ### #
#   # #     #     # #   # #   #   # #   # #       # # # #   #   # #   #   # # # #
# ### # ##### ########### ##### ####### # ####### # # ### ### # ### # ####### ###
#       #       #     # #       #     #         # #       #   #     #   #   #   #
# # ####### ######### # # ##### ##### # ####### ##### ####### # ### # ##### ### #
# #   #     # #     # #   # # # #     # #     # # # #   # # # # #   #     # # # #
# # ####### # # ##### ##### # ##### # ####### # # # # ### # # ##### ####### # # #
# #       #   #   # #   #   #     # #   #           #   # #     # # #         # #
### ##### # ### ### # ### # ##### # ### # ### ##### # ### ##### # ##### ### # # #
#   #     #     # #     # #     # # #     #     # #     # #       #   # #   #   #
# ############### ### ### # ##### # # ######### # ####### ##### ### # ### ##### #
# # #       #     # #     # # #     #   #   #   #       #       # # #       #   #
# # # # ### # ##### ##### ### ### # ### ### # ### ##### # ##### # # ### # # ### #
#   # # # #   #           #   #   # # #     #     #   # #   #   # # # # # # # # #
######### # # # ####### ##### ### ### ##### ##### ### ##### ##### # # # ##### # #
#         # # #   #   #     # #   #   #     #       #       # # # # # #   #   # #
# ##### # # ##### # ### # # # ##### ### ##### ####### # ### # # # # # ##### ### #
# # #   #   #         # # # #       #     # #   #     # # # #           #       #
### ### # # # ####### ##### ##### # # # ### # ##### # ### ##### ##### # ### ### #
#   #   # # #     #   #   # # # # #   #   #     #   #   # # # # #     #   #   # #
# # ##### ### # # ####### # # # # ####### ####### ### # # # # # ##### # ####### #
# # # #   #   # #   # #   #       #       #     #   # #   # # # #     #     # # #
# ### # ####### # ### # ### # ##### # # # # ########### # # # # ##### ##### # ###
#       #   #   #     # # # # #     # # # #   #         #   # #   # # # #     # #
# # # # # # # ### # ### # ### # # ### ####### # # ### # ##### ### # ### # ##### #
# # # #   # # # # #   #   #   # # # #   #     # # #   #           # # #   # #   #
####### # # ### ### ##### # # # # # ####### ######### # ########### # # ### ### #
#       # #     #     #     # # #         #   #       #   # #       #   #   #   #
### ##### # ### # ############# ##### ### ### ##### ####### ##### ### # # ### ###
# #   #   # #   # # #       #   # #   #   #     # # #   #   #     # # #     #   #
# ### ############# ##### ####### # # # ### # ### # # ##### ##### # ##### # ### #
# #       # #         # # #     # # # #   # #   #     #   # #           # # #   #
# # # # # # # ######### # # ##### # ### ### # ##### ### ### # ### ##### # ### ###
#   # # #     #     #     # #   # # #     # # #   # #           # # # # #       #
# # # ### ### # ######### # ### # ### ##### ### ############# ##### # # # ### ###
# # # #   #               #   # #   #   #     #       # # #   #   #       #     #
### # ##### # ### ### ####### # # # ### ### ##### ### # # # # ### ### ### ##### #
#   #   #   #   #   #             #                 # #     #   #       #     # #
############################################################# ###################

