################################################### #############################
# #   #   #   #   #     #   #     #                         # #   #     #       #
# # ### ##### ### ##### # # ##### ####### # ### ### # ### ### # # # # ### #######
#       #             # # # #     #   #   #   # #   # # #     # #   #     # #   #
# ##### # ### ### # ### ### # ### # ### ############# # # ##### ### ### # # # # #
#   #   #   # #   # #   #   # #     #       #         #   #   # #   #   #   # # #
# # # ########### # ### # ### # # # # ### ### ######### # # ##### ####### ### # #
# # #     # #     #     #     # # # # # #   #   #       #     #   #   #       # #
# ### # # # ##### ##### # # # ##### # # ####### ### ### ########### # # # ### # #
# #   # # #         # #   # #   #   #   #   # # #     # # # #     # # # # # # # #
### ####### ##### ### ### ### # # ### ##### # ####### ### # # # ##### ### # # # #
# #       #   #   #     # #   # #             #         #   # #   #   #     # # #
# # # ##### ### ####### # ######### ### # ##### # ### # # ### ### ### ####### ###
#   # # # # #   #         # #         # # #   # # # # #   #   #     # #         #
# ### # # ####### ####### # ##### # # # ### ##### # ### ### ####### # ####### ###
# #   #   #       # #       # #   # # #   # #   #   # # # # #         #       # #
# ##### ######### # # ####### ### ######### # # ### # ### ####### # ### ##### # #
# #   #   #   #   # # #             # #       # #         #       #     # #     #
# # ### ##### ### # # # ##### ### ### ##### # ####### ### # ##### # ### # # # ###
#     # # #   # #   # #     # #     # # #   # #       #     #   # # # # # # #   #
# ##### # # # # ##### ### ##### ### # # ### ### ### ### ####### # ### # # ### ###
#     #     #     #   #   # # #   # #         #   # #     #   #   #   #     #   #
### ### ##### ### # ##### # # # # ### # ##### ####### # ### ### ### # # ### # # #
# #         #   # #   #   #   # # #   #   # #     #   # #       # # # # #   # # #
# # ####### ### ##### # ### ####### # ##### # # # ### ### ##### # ### ### # ### #
#         # # #       #     #   #   # # #   # # # # #   # #   #     # #   # #   #
# ##### ##### ### # ######### ##### ### # ### # ### ######### # ##### ##### # ###
# #   # # # #     #       #       #     #     #   #   #   #       #         # # #
# # # # # # ####### ### # # ### # ######### ######### ### ##### # # ### # # # # #
# # # # #         #   # #     # #   #       #     #             # # # # # # #   #
### ##### ##### # # ### # ############# ### ### ### # ### # ####### # ##### # ###
#         # # # # # #   #   #           #   # # #   #   # #       #     # # # # #
# ### ### # # ### # # ### ##### ### ##### ### # ### # ############# ##### ### # #
# #   #   #         #   #   #     # #   #   #   #   #   # # #   #       # # #   #
### # ### # ####### ##### ######### # # ### ### # ##### # # # # ##### ### # #####
# # # #   #   #         # #   #     # #   # #   #   #         # #   #     # #   #
# ####### # # ### ####### ### ### ##### ### # ####### # ####### ### # ##### # ###
# # # #   # # # #   # # #   #     # # #   #   # #     # #   # #   #   # #       #
# # # ####### # # ### # # ### # ### # # # ### # ### ### ### # # # ### # ####### #
#       # #     #   #   # #   #   #     #   # # #     #     #   # #   #     # # #
####### # # # ####### ##### ### # ### ####### # # ####### ######### # # ### # # #
# #   # # # #     #   #   # #   #       #   # #   # #         #     # # # #     #
# # ### # # ##### ### ### ######### # ##### ### ### # # ### # ####### # # # ### #
# #   #       #     # # #   #     # #     #       #   # #   #   # #   #   # #   #
# # ### # ####### # # # ### # ####### ### ### # ### # # # ####### # ####### # # #
# #   # # #       #   #         #     #       #   # # # # #     #       # # # # #
# ### # # ### ### ####### # ### ### ######### ##### # ### ##### ### ### # ### # #
# #     #   # #     #   # # #       #   #   # # #   #   # #     # # #     # # # #
# # # # ##### ######### ### ####### # # # ### # # ######### # ### ####### # ### #
#   # # # # #         # #   # #       # # #   #     #       # #             # # #
##### # # # ####### ### ##### # # ### ### ######### # ####### # ### ####### # # #
#     #     #     # # # #       # # # # #       #   # # #   #   # #   #         #
### ######### ##### # # # ##### # # ### # ### ### ### # # # # ### # ####### # ###
#     #   #     #   # #       # #   #   # #       # # #   #   #     #       # # #
# # # ### ### # ### # ### # ####### # # # ### ### # # # ### ####### # # ##### # #
# # #   #     #       #   #     #   # #   #   #   #   # #       #   # #     #   #
### #############################################################################

