######### #######################################################################
#       #       # #       # # # #     #         # # # #   #   #         #     # #
### ### ### ### # ### # ### # # ### # # ####### # # # ### # ### ######### ### # #
#   #       # #     # # #     # # # #   # # # # # #   #   # #   #         #   # #
### ### # ### ### ### # # ### # # ####### # # # # # # ### # # # ### # # ##### # #
#   #   #       #   # #   #               #   #     #   #   # #   # # # # # #   #
# ####### # # ##### ### ##### ##### ##### # # ##### ####### ##### ### ### # ### #
#     # # # # #   # #   #     #   #     # # #   # # #   #       #     # #       #
### ### ### ### ##### # ####### ####### ##### # # # # ### ### ######### ### # # #
#   #     # #         #       #               #       #   #     #     #   # # # #
# ### # ### ### # # # # ### ####### # ##### # # # # ##### ##### # # # # ##### ###
# #   #       # # # # # #       # # # #     # # # #   # #   #   # # # #   #     #
# ##### ### ### ##### ########### # # ######### ##### # # ##### ### ##### ### ###
# # #     #     # #   #     #     # #   #   # #   #         #   # # # #     # # #
# # # # ### # ### # # # # # # ### # # # ### # ### ##### # ### # # # # # # ### # #
#   # # #   #   # # #   # # #   #   # # #             # # # # # #   #   # #     #
# ### ##### ##### ##### # ################### # ### # ### # # ### # ### ### ### #
#   #     # # #       # # #           #       # # # #   #   #   # #   # # # #   #
############# ####### # ### # ####### ### # ##### # ##### # ### # ##### # ### ###
# # #       #   #     #     #   #   # #   # #   # # # #   # #     # #     #     #
# # # ### ### ### # # # ######### ### ##### # ### ### # # ##### ### ### # ### ###
#   #   #     #   # # #     # # # # # # # #   #   #     #   # # #   #   #       #
# # ####### # # # ####### # # # # # ### # ### # ####### ### # ### ##### ####### #
# #   #     # # #     #   #   #     #     # #     #     # # #     #     # #   # #
##### # # ### ### ##### ### ### ##### ##### ##### # ### # # # # ##### # # # ### #
#     # # #         #   #     #   #   #       #   # # #   # # # # #   #   #   # #
# ####### ### ### # # ##### # ### # ####### # # ### # ##### # ### ### ### # ### #
# #     # #   #   # #   # # #   #       # # # #   # # #     #   #     #   #     #
# # ### ######### # ##### ########### # # # ####### # ### ### # ##### ### # ### #
# # # #     # #   # #   #     # #     # #   #     # #     #   #       # # # #   #
# # # ### ### ### ### # # # ### # ####### ####### # # ### ##### ##### # # #######
# #     #   # #   #   #   #         #   #         # #   # #     # # #   #   #   #
# ### ### ### # ### ##### ### # ####### # # ######### # ### ### # # ######### ###
#       # # #   #   # #   # # #       #   # # # # #   #     #       #     #     #
# ##### ### ### ##### ### # ### # ### # ### # # # ######### # ##### ### # ##### #
# # #         #       #     # # # #   #   #   #     #       # #         #   #   #
### ##### ### ####### ### ### # # ### # # ##### ### # # # # ##### ##### ### ### #
# #     #   # #             #   # #   # # #   # #   # # # # # #       # #       #
# # # ### ####### ##### # ######### ### # # ### ##### ### # # ##### # ##### ### #
#   #     # #         # # #   #   # #   #   #   #     # # # #   #   # #     # # #
##### # # # ### # ##### ### # # # ####### ### ##### # # ### # # # ### ##### # # #
#   # # #     # #     #   # #   #     # #   #       #   #   # #     #     # # # #
### ### ############### ##### ### # ### # ####### ### # ### ### # # # ####### ###
#           # #     #       #   # #   # #     # # # # # # #   # # # #   # #   # #
# # ### ##### ##### # # # ### ######### # # ### # # ##### # # ### ##### # ### # #
# # #   # #       # # # # #   #       #   #       #   #     # #   #   #         #
# # ### # # ##### # # ### # ####### # # # ##### # # ### # # ### ### ######### # #
# #   # #   # #   #     #     #   # #   #   #   #     # # # #       # #     # # #
# ### # # ### ##### ### # ##### ### ### ### ### ### ### # ####### ### ##### # # #
# #   #     #   #   #   #       #   #   #     #   # #   # #         #       # # #
# ### ### # # ### ######### # ### ##### # ##### # ### ### ####### ######### # # #
#   #   # #   #       #     #       #   # #   # # #   #   #     #         # # # #
# ### ####### # ##### ##### ####### # ### # ####### ######### # ##### # ### ### #
#   #   #           #   #       #   #   #         #           # #     #     #   #
################################################################# ###############

