##################################################### ###########################
#   #   #     # # # #         #     # #   #           # # # #   #   #       #   #
### ### ##### # # # # ######### ##### # # ### # ### # # # # # ##### # ######### #
#         #   # # #     #     # # # #   # #   #   # #         # #   #     # #   #
### ######### # # # # # # # ### # # # # ####### ############# # # ### # # # ### #
#           #       # # # # #   # # # #     #   # #   #   #       #   # #       #
####### ### ### ####### # ### ### # # # ####### # # ### # ####### # ####### ### #
# #   #   # #   # #   #   #     # # # # #               # #   #     # #   # # # #
# # # ##### ### # # # ### # ### # # # ### # ########### ##### # # ### # ##### # #
# # #     #       # # # #   # #   #   #   #         #     # #   # # #   # # # # #
# # ### ##### ### # # # ##### # ##### ##### # ##### ##### # ### # # # ### # # # #
#     # # # #   #   # # #     # # #     # # # # # # # # #   #   #   #           #
### ##### # ### # ### # # # ##### ##### # ### # # # # # # ##### ######### ### ###
#       # #   # # # # #   # # #           #     # #   # #     # #     # # #     #
# # ### # # ### ### # ### # # # # # # # ##### ### # ### # ##### # ##### #########
# # #     # # # #   #     # #   # # # # #   # #   #   # # #   # # #       # #   #
### ##### # # ##### # ##### # ######### ### # ### ##### ##### ### ### ##### ### #
#   # # # #           #   # #   #   #   # #   #       #             #   #       #
### # # # ### # ### ### ##### ### ### ### # ### # # ####### ##### ### ##### # ###
#   #   # #   # #     #     #       # #       # # #   #   # #     #   # # # #   #
### ### # # # ##### # # ######### # # # ######### # # # # # ### ### ### # # # ###
#   #       #   # # #   #       # # #   #     # # # # # # # #     # # # # # # # #
##### # ### # ### # ##### ##### # ### # # ### # ### ### ##### ##### # # # ### # #
#     #   # # #   #   #   # #     #   #   #     # #   #   #     #   #           #
# ### ##### # # # ####### # # ##### ### ### ##### # ##### # ### # # ### ##### # #
#   #     # #   # # # # # #   #   # #   # #     #   #   #   # # # #   # #   # # #
##### ### ### ##### # # ######### # # # # # ##### ### # ### # ### # ####### ### #
# #   # # #   #       #   #       # # # # # #   # #   #   #       #   #   #     #
# # ### # # # ### ### # # ### # ### ### # # # ### # ########### ### ### ### #####
#     #   # #       #   #   # #       #   #   #           # #     #   #       # #
# # # ### ##### ######### # ##### # ####### # # # ### ##### # # ### ### ##### # #
# # # # # #     #   #     #   #   # #     # # # #   #   #     # # # #   #       #
### ### ### # ##### ##### # ### # # ### ### # # # ##### # ### ### # ##### # #####
#   # # # # #         #   # #   # # #   #   #   #     # # # #   # #   #   #   # #
# # # # # # ####### # # # ### ### ##### ### ### # ##### # # # ### ### ### ##### #
# #   # #     #     # # # #   #   # #       #   # # #   #   #   #   #     #     #
##### # ### # ### # # ### # # ##### ##### ### # # # # ### ### # ### ### ####### #
#     # #   #   # # # #   # #     #   # # #   # # # #     #   # #             # #
# ##### ### # # ####### # # ##### # # # ##### # # # ### ### ####### ### ##### # #
# # # #     # # #   #   #   # #   # # #       # #   #   #   #   #   # # #       #
# # # ### ##### ### ####### # # ### ### ### # ### ####### ##### ##### ###########
#   #       #   #     # #   # # # #       # #   #       #   #     #             #
##### ### ### ### ##### ##### # # # # # # ######### ### ##### ####### # ### #####
#   # # # #   #   #       #     #   # # #     #     #   #   # #       # # # #   #
# # # # ##### # ######### # # ####### ### ### ### ####### # # ########### # # ###
# # #     #     # #   # #   # # #   # #     #   #   #   # #   #     # # #     # #
### ### ### # ### ### # ### # # # ##### ### ####### # ### ######### # # ### # # #
#     #   # # #   # #       # # #   #     #   # #     #         #   #     # #   #
# # ####### ### ### # ####### # # ### ### ##### # # ##### ### # ### # # ####### #
# # #   #     # #   #   #   # #       # # #       #   # # # # # #   # #   #     #
# ### # # ### # ### # # ### ##### ##### # ### ### ### # # # ##### ##### ### # ###
# #   # # #         # #       # #       #   # # #   # #   #   #         #   #   #
# # # # ### ##### ### # ####### ### # ####### # ### # # # ### ### ### # # ### # #
#   # #     #       # #     # #   # #   # # #   #   # # #       # #   #     # # #
##### ##### ### # ##### ### # ### # # ### # # ### ### # ####### # ##### # # # # #
#     #     #   #     # #   #       #       #   #   #     #       #     # # # # #
######################### #######################################################

