############################# ###################################################
#       #     # # #       #     #     #   # #     #     #       #               #
##### # # ### # # # ####### ######### # # # # ##### ##### # ##### # # ##### # # #
#     # # #   # #                     # #   #           # #   #   # # # #   # # #
# ######### ### ### ######### ##### ##### ### # ##### # ### # # ### ### ##### ###
# #           # # #     #   # #       #   #   #   # # # #   #   # #       #     #
# # ########### # # ##### # # ##### ##### # # ### # ### # # ### # ##### ####### #
# #     # #     # #   #   #     # # #   #   #   #   #     #   # #   #   #   # # #
# # ### # ##### # # # ### ####### ### ### ####### # # ####### ### # ### # # # # #
# #   #       #     # # #           # #       # # # # # #       # # #   # #     #
# # ######### ### ### # ##### ### ### # # ##### ### ### ####### ### # ####### ###
#   # #       #   #         # #       # #   #   # # #   # # #     # # #   # #   #
# # # ######### ### ##### # ####### # # ####### # ##### # # # # # # # ### # #####
# #     # #     #     # # # #     # #     #   #     #       # # # #   #         #
##### ### ### # ####### ### # ##### ######### # ### ### ##### ##### ####### ### #
# #         # #       #     # #         #   # #   # #   #   # #   #       # #   #
# ### # ####### ### ### ##### # ### ##### ### ### ### # # ##### # # ### ### ### #
# #   # #   #   #   # #       # #     #       #       #       # #   #         # #
# # ##### # ### ##### ### ##### ##### ##### ### ### ### ##### ######### ### ### #
#         #       #         #   # # # #     #   # #   # # #   #       # #   #   #
##### # ### ####### # ### ##### # # # ##### # ### # # ### ### # ### ####### ### #
#   # # #   #       # # # # # #     # # #   #   # # #     # # #   #         # # #
### ### ### ##### ### # ### # ### ##### ### ### # ######### # ### ####### ### # #
# #       #   #   #   # #     #     #   #   # #   #   #       # #   # #     #   #
# # # ############# ### ##### # ####### # ### ##### ### ### # # ### # ### ##### #
#   # #         #         # # # # # #   #     # #   #   # # #   #     # # #     #
### # # ######### ####### # # ### # ### ### ### ### ### # ####### ### # ####### #
#   #       #   #   # #   #       #         #   #   # #   # #     # #   # #   # #
########### ### # ### # ##### ### # ### # ### # # ### # ### ##### # # # # # ### #
#   # # # #     # #     #       #   #   # # # # #     # #     #   #   #       # #
### # # # # # ### ### ##### # ### ##### ### # # # # ### # ### # # # # # ##### # #
#           # #   #   #     # # # #           # # #   # # #     # # # # # #   # #
# ######### # ####### ######### ##### # ####### ##### # ### # # # ### ### # # # #
#     #     #   #     # #         # # # #   # # #   #   # # # # # # # # #   # # #
### ################# # # # ##### # # ### ### ##### # # # ####### # # # ####### #
#   # # #             # # #   #             # #   #   #     #   #   # # #       #
### # # ### ##### # ### ######### ########### # # # ### ####### # ##### ####### #
#     # #   # # # # #     #         # #         # #   # #   #   # # # #       # #
### # # ##### # ### # # ##### ##### # ### ### ### # # ##### # ### # # # # ##### #
# # # # #     #       #   # #     #     # #   # #   #   #     #   #     #       #
# # ### ### ####### ### # # ### ### # ### ##### ### ##### ### ##### ######### ###
#     #     #   #     # # #   # # # #   #   #     # # #     #   #       #   #   #
# ### ### # ### # ### ##### ##### ##### ### # ##### # ### ### # # ### ### # ### #
# # #   # #       # # # #   #         #   #   # #         #   #   # #   # #     #
# # ####### ##### # ### ### ##### # # ### # ### ### ### ### ####### ##### ### # #
#       # #     # #   #   #   # # # #     #     # #   #   # #       #   # #   # #
# ####### ### # ### ### # ### # # ##### ######### # ### # ### ######### ### ### #
# #     #     #   #     #     #   #   # # # # # # # #   # #   # #     # # # #   #
# ### ##### ######### ### ### ### # ##### # # # # # # ####### # ##### # # # # # #
# #   # # # # #     #   #   #       # # #   #   # # #       # #           # # # #
# # # # # # # ##### ######### # # ### # # ##### # # ### # # # ### # ##### ### ###
#   # # # #       # #       # # #     #     #     #   # # # #   # # #     #   # #
# ### # # # ##### # # ############# # ##### # ####### ### ### # # ####### ##### #
# #     #     #               #   # #                   # # # #         #       #
##### # ### ######### ##### ### ### # ##### # ######### # # ##### ### # ####### #
#     #   #       #   #         #   # #     #   #       #           # #     #   #
################################################# ###############################

