################################################# ###############################
#             #   #   #             #     #   #       # #     #     #     #     #
# # ### # ##### ##### ### # ############# ### # ##### # ### ### ##### # # ##### #
# # #   #   # # #         #               #   # #     #       #       # #       #
# ### ### # # # ##### ####### ### # ### ### ### # ##### ##### # # # ### ##### # #
#   # # # # # #       #   # #   # #   #         # #     #     # # #   # #     # #
# ### # # ### ##### ### ### # ######### # # ### ##### ####### ##### # ####### ###
#   #   #     #   #   #           # #   # # #         #   # #       #   #     # #
##### ### # ##### ##### ######### # ### ### ####### ##### # ##### ### ### ### # #
#       # # #     #   # #       #   # # #     #     # #   #         #   # # #   #
# ######### # # # # # # ### ### ##### ####### ##### # # ##### # ####### # # #####
#   #     #   # # # # #   #   #     #   #     # #   #   #     # #   # # # #     #
# ##### # ##### ### ##### # ####### # ##### ### # # ### ##### # # # # ### # #####
# # # # # # #   # #           #     #   #     #   #     #     # # # #           #
# # # # ### # ### ######### ####### ### ### ######### ##### ### ### ### ####### #
#   #     #   # #     # #         # #     #     #         #   # # #   #   # #   #
# # ##### # ### ##### # ##### ########### ############# ##### ### ### # # # # # #
# #   # #         #       #   # # # # # #   # #   #         #   #       # #   # #
### ### ####### ### ##### # # # # # # # # # # ### ### ####### ### ########### ###
#     #       #   # # #   # #   #     #   #         #     # #   # # # # #       #
# ####### ### # ### # ### ##### ### ### ### ####### # # ### ####### # # # #######
#   #   #   # #   # # #     #         #   # #     # # # # #     #     # # #     #
### # # # ######### # # ##### ### ### ##### ##### # # # # # ### ### # # # ### ###
#   # # # #     # #   # # # # #   # # # #   # #   # # # # # #   #   #   #   # # #
# ### ### # # # # ### # # # ####### # # # ### # ### ### # # # ### # # ### # # # #
#   #   #   # #     # #     #   #   # #       #     #       # #   # # # # # #   #
# ### ############# # ### ### # # # # # # ####### # ### # ##### ####### ### # ###
#           # #   # # #     # #   #     # #   #   # #   #       #   #           #
### # ####### # ### # ### # ######### # ### ####### # ### ####### # # ######### #
#   #   #   #   #     #   #     # #   #   #       # # # # # #     #         #   #
# ####### # ### # # ############# # ### ##### # ####### # # ### # ##### # ##### #
#         # #   # # # # #   # # #   #     #   # # #     # #   # # # #   #   #   #
##### ####### ##### # # ### # # ### # ### ##### # ##### # # ### # # # # # # # ###
#   #     #   #       #   # #   #   # # #   #   #   # #     # # # #   # # # # # #
# ##### # ### ### # ##### # # ####### # # ### ##### # ##### # ### # ##### # ### #
#       #     # # #   # #   # # # #   #   #   #       # # #   #   # #     #     #
# ######### ### ### ### # ### # # ### ####### # # ### # # # # ### ### ##### #####
#     # #   #   # #   # #   #       # #     #   # #         # #   # #     #     #
##### # ### # ### # ### # ######### ### ### ####### # ### # ####### # ##### ### #
#       # # #             #     #     # #   #   # # #   # #   #     # # #   #   #
##### ### # ####### # ### # ### # # ##### ### ### ### # ### ### ####### ### ### #
#   #     #   #   # # #   # #     # # #     #         # #       # #   #   # # # #
### # ####### ### # # # ######### # # # ######### # ####### ### # # # # # # # # #
#   # #     # #     # # #   # # # #     #         #   #       #   # #   # # #   #
### # ### # # # ##### ##### # # # ### ### # ##### # ### ######### ##### #########
#     # # #     # #     # #         # #   #   #   # # # #     #   #       #   # #
####### ### ### # # ### # # ### ##### # # ### ### ### # ### ##### ##### # ### # #
#       #   # # #     # #     #   # # # #   #   # # #   # #             # #     #
# # # ### ### # ### # ### ### ### # ### ### ##### # ### # ########### # # ### ###
# # #         # #   # #   # #   #   #   #     #     #   # # #   #   # # #   #   #
# # # # ### # ####### ##### ##### # ### ######### ### # # # # # ### ### # ### ###
# # # # #   #       # # #   #     #       #   #     # #   #   #     #   #     # #
# ### ### ### ##### # # ### ####### ##### # ##### ##### ### ####### # ### ##### #
#   # #   #       # #                 #       #       #       #     #   #       #
################################################################# ###############

