######################### #######################################################
# #         #   #     #       #       #   #               #       #       #   # #
# # # ##### # # # ### # ### # ### ##### # # ### ######### ##### ### # ### # # # #
# # #   # # # #   #   #   # #     #     #     # #       #     #     # #   # # # #
# # ### # # # ##### ##### # ##### # ########### ##### # ##### ##### # # ### # # #
#     # # # # #   #     # # #   # # #     #   #   #   # #   #     # # #     #   #
####### # # ### # ##### # # # # # # # ### # # ### # ### # # ##### ### ######### #
#       #       # #   #   # # # # #   #   # #     #   # # # #   # #   # #     # #
# ####### ####### # # ### # # # ### ####### ####### # # # # # ### # ### # # ### #
# #   # # # #   #   #   # #   #     #     #   #   # # #   #   #   # #     # #   #
# # # # # # # ######### ############# ### # # ### # # ######### ### ####### # ###
#   # #     # #   #   #           #   #   # #   #   #     #   #   # #     # #   #
# ### ##### # # # ### ########### # ### ####### ######### # # ### # # ### # ### #
#   #     # # # #   #       #   #   # #         #       #   #   # #   #   #   # #
### ##### ### # ### # ##### # # ##### ########### ##### # ##### # ##### ### # # #
#   #     #   # #   #   # #   #   #           #   #     #   #   # #     #   # # #
# ### ##### ### # ##### # ####### ##### ##### # ### ######### # # # ##### ##### #
# #   #   #   # #   #   #       #   #   #       #     #       # #   #   #       #
# # ### # ### # ### # ####### ##### # ### ########### ### ##### ##### ### #######
# # #   #   #   #   #   #   #     #   # #     #   #       #       # #     #     #
### # ##### ##### ##### # # ### # ##### # ##### # ####### ####### # # ##### #####
#   #   #     #   #   #   #   # #       # #     #   #   # #     # # #   #       #
# ##### # ### # ### # # ##### ####### ### # ####### ### # # ### # # ### ####### #
# #     #   # #     # # #   #       #     # #     #   #   # # # # #   #         #
# # ####### # ####### # # # ####### # ##### # # # ### # ### # # # ### ######### #
#     #     # #     # # # #     #   # # #   # # # # # #   #   # #   #         # #
# ##### ##### # ##### ### ##### # ### # # ##### # # # ####### # ### # # ##### # #
# # #   #   # #     #     #   # # # # # # #     # # #         # #   # # #     # #
# # # ### # # # ### ####### # # # # # # # ### ### # ########### # ##### ####### #
# # #   # #   #   #     #   # # # #     #     # # #       #     #       #       #
# # ### # ####### ### # ### ### # ##### ####### # # ##### # ### ####### # #######
# # #   #   #     #   #   # #   # #   # #       # #   #   # #   #   #   # #     #
# # # ##### # ##### ##### # # ### # # # # ##### # ### # # # # ### # ##### # ### #
#   # #   # #     #   # #   #   # # # # #   # #   # # # # # # #   #       # # # #
### # # # # ######### # ### ### # # # # ### # ##### # # ### ### ########### # # #
#   #   # #           #     #   #   # # # # #         #   #   # #         #   # #
######### ########### ##### # ####### # # # ############# ### # # ####### ### # #
#   #   #     #       #   # #   #     #   # #               #   # #     #     # #
# # # # # ### ######### # ##### # ##### ### # ############# ##### # # ######### #
# # # # # #   #         #   #   # #   # #   # #   #         #   # # #     # #   #
# # # # ### ### ########### # ### # # # # ### # # # ######### # # ##### # # # # #
# #   #   #   # #         # #   # # # # #     # # #   #   #   # # #     #   # # #
# ####### ### # ##### ### # ### # # # # ######### ### # # # ### # # ######### ###
# #     #   # #       #   #   # # # # #         #   # # # # #   #   #       #   #
# # ### ### # ####### ##### ### # # # ######### ### # # # # ####### # ##### # # #
# # # #   # #     #   #     #   #   # #             #   # #     #   #   # # # # #
# # # ### # ### # # ### ##### ####### # ####### ######### # ### # ##### # # # # #
# #   # # #     # # # #       #       # #     # #   #   # # #   # #     #   # # #
# ### # # # ####### # ######### # ##### # ### ### # # # # # # ### # ##### ##### #
# #     #   #   #   #       #   # #     # # # #   #   # # # #     #   # # #     #
# ########### # # ####### ### ### ### ### # # # ####### # # ######### # # # ### #
# #   #       # # #     #     # #   # #   # #   #     #   #     #   # # # # # # #
# # # # ####### # # ### # ##### ### ### ### ##### # # ######### # # # # # # # # #
# # #   #     # #   # # #     #   #   #   #   #   # #   #   #   # #   # #   #   #
# # ####### # # ##### # ##### ### ### ### # # ##### ### # # ##### ##### ##### ###
#           # #         #           #       #       #     #       #             #
######################################################################### #######

