################### #############################################################
#           #         #     #   #         #       #         # #       #   #   # #
# ######### # # ####### # # ### # # ##### # ##### ### ##### # # ### # # # # # # #
# #   #     # # #   #   # #     # # #   #   #     #   #   # #     # # # #   #   #
# # # # ##### # # # # ### ### ### # # # ##### ##### ### # # ####### # # ####### #
#   # # #     #   # #   # # # #   # # #     # # #   #   #   #       #   #   #   #
##### # # ######### # ### # # # ### # ### ### # # # # ####### ########### # # ###
#   # #   #   #   #   #   #   #   # #   #     #   # # #     #   #   #     # # # #
# # # ##### # # # ##### ### ##### # ### ########### # ### # # # ### # ##### # # #
# # #       # # #     # # # # #   # # # #       #   #   # #   # #   #     #     #
### ######### ####### # # # # # ### # # ### ### # ##### # ##### # ### ###########
#   #       #   #   # # #     #   # #     # # # #   #   #   #   #     #         #
# ### ##### ### # # # # ### ##### # ##### # # # ### # ##### # ### ##### ####### #
# #   #       #   #   #   # #     #     #   #       # #   # # #   #   #       # #
# # ### ############# ### ### ######### ############# # ### # ##### # # ####### #
# #   # #           # # # #   # #     # #     #     # #     #   #   #   #     # #
# ### # # ### ####### # # # ### # # # # # ### # # ### ##### ### # ####### ### # #
# #   #   # #         # #   #     # # # # # # # #   # #   #   # # #     # #   # #
# # ####### ########### ##### ##### # # # # # ### # # # # ##### # # ### # # ### #
# #     #   #           # #   #     # #   # #   # #   # # #     #   #   # #     #
# ##### # # # ### ##### # # ### ##### ##### ### # ##### # # ### ##### ### #######
#     # # # #   #     # # # # #     # # #     # #       #   #   # #   # # #     #
# ### # # # ######### # # # # ##### # # # ### # ############# ### # ### # ##### #
# # #   # #           # #   #   #   # #     # #     #         #   #     #     # #
# # ##### ############# ### ### # ### # ##### ##### # ##### ##### ##### ##### # #
#   #     #           #   #     # #   # #       #   # #   # #     #       #   # #
### ### ### ##### # ##### ### ### # ##### # ##### ##### # # ### # # ##### # ### #
# # #   #   #   # #       #   #   #     # # #     #     # #     # # #   # #   # #
# # # ### ### # ##### ######### ####### # ### ##### ##### ####### # ### # ### # #
#   #   #   # #     #       #   # #     #   #       #   # #       #   # #   # # #
# ### # ##### ##### ####### # ### # ####### ######### # # # ######### # ##### # #
#   # #         #   # #   #   #   # #       #     #   #   # #   # #   #       # #
### # ########### ### # # ##### # # # # ### # # ### ####### # # # # ########### #
#   # #     #   # # #   #       # # # # #   # # #   #         #   # #           #
# ### ### ### # # # # ####### ### # ### # ##### # ############# ### # ##### ### #
#   #     #   # # #     #   #   # #     #       #     #     #   #   # #   #   # #
### ##### # ### # ####### # ### ############### ##### # ### ##### ### # # ### # #
# # #   # #   # #   #     #   # #               #   # # # #       #     #   # # #
# # # ### ### # ### # ####### # # ############### # # # # ############### ### # #
#   #     #   #   # #   #   # #   #       #       # #   #               # #   # #
# ### ##### ##### # ### ### # # ### # ### ### # ### ########### # ##### ### ### #
#   #   # #   #   #         # #   # # # #   # # #   #     #   # # #   #     # # #
### ### # ### # ############# ### ### # ### ### # ### ### # # ### ### ####### # #
# #   # #   # #       #     #   #     #   #     #   #   # # #   #   #         # #
# ### # # ### ####### # ### ### ####### ########### # # # # ### # # # ##### ### #
# #   # # #   #     #   # #   # #                 # # # #   # # # # #   #   #   #
# # ### # # ### ### ##### ### # ########### ####### # # ##### # ### ##### # # ###
#   # #   #   # # # #       # #   #       #       # # #   #   #   #   #   # #   #
# ### ### ### # # # # ##### # ### # ##### ####### # ### # # ##### ### # ### ### #
#   #     #   # # # #     # #   #       #   #     #   # # #           #   # #   #
### ####### ### # # ####### ### ########### # ### ### # # ############### # # ###
#   #       #   #             #       #     #   #   # # # #     #   #     # #   #
# ### ####### # ##################### # ##### # ### # ### # ### # # # ##### ### #
#   # #       # #             #     # #     # #   # #   #     #   # # #   #   # #
### # # ### ##### ########### # ### # ##### # ### ##### ########### # # # ##### #
#     #   #                 #     #         #   #                   #   #       #
####################################### #########################################

