########################################################################### #####
#                   #   #   #     #                   #           # #       #   #
####### ########### # # ### # # # # ########### ##### # ### ##### # # ### # # # #
#     # #         #   #   #   # # # #       # # #   # # # # #   # #   #   # # # #
# ### # # # ############# # ### # # # # ### # # # ### # # # # ### # ### ### # # #
#   #   # #     #       # # #   # # # #   # # # # #   #   # #     # #   # # # # #
# # ##### ##### # # ##### ### ##### ##### # # # # # ##### # # ##### # ### # ### #
# #   # #     #   # #   #   # #           # # # #   #   # # #   #   # #   #   # #
# ### # ##### ##### # # ### # # ########### # # # ### # # # ### ##### # # ### # #
#   # #   #     #   # #   # #       #     # # # # #   #   # #       # # #   #   #
### # # # # ##### ### ### # ######### ### # # # # ### ##### ####### # ##### ### #
#   # # #   #   #   #   # #   #   #   #   #   # #   #   # #     # # #     #   # #
##### ####### # ### ### # ### # # # ### ####### ### ### # ##### # # # ### # ### #
#     #       # #     # #   # # #   # #         # # #   #   #   #   #   # #   # #
# ##### ####### # ##### ### # # ##### ########### # ### # # # ### ####### # # # #
# #           # # #   #   # # # #     #   #       #   #   # #   # #       # #   #
# ####### ### # # # # # ### # # ### # ### # ##### ### ##### ### # # ####### #####
#       # #   #   # #   #   #   #   #   #   #       #   #   #   #   #     # #   #
# ##### ### ### ### ##### ####### ##### ##### ######### # ### ########### # ### #
# #     #   # # #   #   # #       #       #   #         #   #   #         #   # #
# # ##### ### # # ### # # # ##### ####### # ### ############### # ####### ### # #
# # #     #     # #   # #   #   #     # # # #   #               # #     # #   # #
# # ##### ####### # ### # ##### ##### # # # # ### ############### ### ### # ### #
# #     #         #   # # #       #   #     #     #     #           #     #     #
####### # ########### # # # ##### # ############### ### ####### ### ##### ##### #
#   #   # #         # # # # # #   #                 # # #     #   #     # # #   #
# # # ### ##### ##### # # # # # ############### ##### # # ### ##### ### # # # ###
# # #   #   #   #     # #   # #   # #         # # #   #   #   #   #   # #   # # #
# # ### ### # # # ##### ##### ### # # ##### # # # # # ##### ### # ### # # ### # #
# #     # #   # #   # #   #   #   #   #     # # # # #       #   #   # # # #   # #
# ####### ### ##### # ### # ### ####### ##### # # # ####### # ##### ### # # ### #
# #       #   #     #   # #             #     # #   #     # # #   # #   # #   # #
# ### ### # ### ##### # # ############### ##### # ### ### # # # # # # ####### # #
# #   #   #   #     # # #     #   #   #   #   # #   #   # #   # # # #       # # #
# # ##### ### ##### ### ##### # # # # # ##### # ####### # ##### ### # ##### # # #
# # #   #   #     #     #   #   #   # # #     #         # #     #   # #     # # #
# # # # ####### ####### # # ######### # # # # ########### # ### # ##### ### # # #
# #   #         #   #   # #     #   # # # # # #         # #   # # #     #   # # #
# ##### ######### # # ### ##### # # # # ### ### ####### # # # ### # # ####### # #
#     #   #       # #     #   # # #   #     #   #     # # # #       # #       # #
# ### ### # ####### ####### # # # ######### # ### ##### # ########### # ####### #
#   # #   #       #     #   #   #   #       #   # #     # #     #     # #       #
### # # ### ####### ### # ######### # ######### # # ##### # ### ####### # ##### #
#   # #   # #     # #   #         # #       #   # # #     # # # #       # #     #
# ### ##### # ### # ### ######### # ######### ### # # ##### # # # ####### # #####
# # #       # #   #   #   #   #   #     #     #   # # #     # # # #       # #   #
# # ######### # ##### ### ### # ####### # ##### ### # # ##### # # # ### ### # ###
# #   #       #     # #       #   #     #     #       #   #   # # #   # # # #   #
# # # # ########### # # ####### ### ##### ### ####### ### # ### # ##### # # ### #
#   # # #   #     #   # #       #   #   # # #     #   #   # #   #       #   #   #
### ### # ### ### ##### # ####### ### ### # ##### ##### ### # ########### ### # #
# # #   #       # #     # # #     #       #     #     # #   #   #       #     # #
# # # # ######### # ##### # # ######### ##### # ##### # ### ### # # ########### #
# # # # #       #       # # #         #       # # #   #     # #   #       #     #
# # # ### ##### ######### # ######### ######### # # ####### # ######### ### #####
#   #         #                   #   #           #                   #         #
############################################### #################################

