############################################# ###################################
#           #       # #       #       #             #     #     #               #
# ### ##### # # ### # # ##### # ####### ####### ### # ### # ### ### ########### #
#   # #     # # # #   # #     # #     #   #     #     #     #       #         # #
### # # ####### # ### # # ##### # ### # ### ##### ################### ##### ### #
#   # # #   #   #     # #   #   # # #   #   #   # # #           #   #   #   #   #
# ### # # # # ######### ### # # # # ##### ##### # # # ######### # # ### # ### ###
# #   # # # #       # #   # # # #     # #     # #   # #   #     # #   # # #   # #
### ### # # ##### # # ### # # ####### # ##### # # ### ### # ##### ### # ### ### #
#   # # # # #   # # # #   # #         #   #   #   #   #   #     # #   #         #
# ### # # # # # ### # # ### ##### ##### ### ### ### ### # ##### # # ### ####### #
# #       #   #     # #   #     #   #   #   # #   #     # #   #   #   # #     # #
# ################# # ### ##### ### ### # ### ### ####### # ######### ### ### # #
#   #         #   # # #   #     #       #   #           # #         # #   #   # #
# # # ####### # # # # # ### ############### # ########### ### # ##### # ### #####
# # #   # #   # #   #   #   #         #   # # #   #     #   # # #     # # # #   #
# # ### # # ############# ### # ##### # # # ### # # ### ### # ### ### # # # # # #
# # #     #     #         #   # #       # #     #     #   # #   #   # #   #   # #
# # # ##### ### # ######### ### ######### ############# ### ### ### ### ####### #
# #   #   #   # #   #     #   #       # #       #     #         # #     #     # #
# ##### # ##### ### # # # ########### # ####### # ### # ####### # ####### ### # #
# #   # #     # #   # # # #   #     # #   #   # # # # # #   #   #   #   # # # # #
# ### # ##### # # ### # # # # # ### # ### # # # # # # # # # ### # # ### # # # # #
#   # # #   # # #   # # #   #   # #   #   # #   # #   # # #   #   #     # # #   #
### # # ### # # ### ### ######### ##### ### ##### # ##### ### ######### # # ### #
# #   #   #     # # #   #     #           #   #   # #     # #         # # #   # #
# ### ### ##### # # # ### ### # ######### ### # # # ### ### ######### # # # ### #
#   #   #   #     # #   #   # # #   #   #     # # #     #           # # # # #   #
# ##### ### ####### ### ### ### # # # # ####### # ####### # # ####### ### # # ###
# #       #   #   #     #   #   # # # #         #   #   # # # #       #   # # # #
# # ######### # # ####### ### ### ### ############# # ### # ### ####### ### # # #
#     #   #   # #       #     # #     #   #         #   # # #   #       #       #
####### # # # # ####### # ##### # ##### # # ########### # # # ######### ####### #
#       #   # # #   #   # #   #       # # #           #   #       #   # #   #   #
# ######### ### # ### ### # # ######### # ######### # ########### # # # # # ### #
#   #     # #   #   #   #   #         # # #       # #       #   # # # #   #   # #
# # ##### # # ##### ### ############# # # # ##### # ####### # # # # # ####### # #
# #   #   # # #   #   #   #   #     # # # # # #   # #     # # # #   #   #     # #
# ### # ### # # # # # # ### # # # # # # # # # # ### ### ### # ######### # ##### #
# # # # #   # # #   # #   # #   # # # # #   #   # #   #   # #         # # #     #
# # # # # ### # ##### ### # ##### # # # ##### ### ### ### # ####### # # # # #####
#   # #     #   #   #   #   #     # #   #   #   #         # #     # # # # #   # #
### # ########### ### ####### ### ####### # ### ######### # # ### # # # # ### # #
#   #         #     # #       #   #     # #   # #       # #     # # # #   #   # #
# ######### # # ### # # ########### # # # # ### # ##### ### ##### # # ##### ### #
# #     # # # # # #   #   #         # # # #   #   #   #   # #     # # #   #   # #
# # ### # # ### # ####### # ######### # # ### ##### ##### # # ##### ### # ### # #
# #   #   #   # #   #   # # #       # # # # # #     #   # # # #   #     #   # # #
# ### ### ### # # # # # # # ##### ### # # # # # ### # # # ### # ### ####### # # #
#   #   #   # #   # # #   #       #   # #   # #   #   # #     # #   # #   # #   #
### # # ### # ##### # ########### # ##### ### ### ##### ####### # ### # # # ### #
# # # # #   #   #   #       #   # # #   # #   # #     #   #     #   # # # #   # #
# # # # # ### ### ####### ### # # # # # # # # # ##### ### # # ##### # # # # # # #
#   # # # # #     #     #     #   # # # # # #   #   # # #   #   #   # # #   # # #
# ##### # # ########### ########### # # # # ##### # # # ####### # ### # ####### #
#       #                         #   #   #       #           #       #         #
############################################################### #################

