######################################################################### #######
#       #         #         #                       #           #     #         #
# # ##### # ##### # ### ### # ##### ############### # ######### # ### # ### #####
# #   #   #     # #   # # # #   #   #     #         # #       #   #   #   #     #
# ### # ####### ### ### # # # ### # # ### # ######### # ##### # ######### ##### #
# #   #     # #     #   #   # #   # # # # #         #   # #   # #         #   # #
### # ##### # ####### ### ##### ##### # # ######### # ### # ##### ######### # # #
#   # #   # #   # #   # #   #   #   # # # #     #   # #   #   #   #     #   # # #
# ### # ### # # # # ### ### # ### # # # # ##### # ### # # ### # ##### # ##### # #
# #     #   # #   # #     # #     # #   # #     # #   # #   #   #     #       # #
# # ##### ### ##### ### ### # ##### ### # # ##### # ##### ######### ### ##### # #
# #   #   #   #   #   #   # #   #   #   # #       #     #           #   #   # # #
# # ### ##### # # ### # # # # ### ### ### # ########### ### ######### ### # ### #
# # #   #     # #   # # # # # #   #     # #     #     # #   #       #   # #   # #
# # # ### ##### ### # # # # ### ### ##### ##### # ##### # # # ##### ##### ### # #
# # #   #       #   # # # #   #     # #   #   # #   #     # #     #       # #   #
# ##### ######### # # ### ### # ##### # ##### # # # # ####### ### ######### ### #
#     # #     #   # #   #     # #     # #     # # #   #     #   # #             #
# ### # # ### # ### ### # ##### ### # # ### ### ####### ### ### # ############# #
# #   #   #   # #   #   # #   #     # #   #   #         #     # #     #       # #
# # ####### ### # ### ### # # ####### ### ### ### ########### ####### # ##### ###
# # #     #   # #   # #   # #           # #   #   #       #   #   #   # #   #   #
# # # ### ### # ### # # ################# # ### ### ##### ### # # # # # # # ### #
# # # #   #   #   # # # #         #       #     # # #   #   #   #   # # # #   # #
# # # # # # ##### # # # ### ##### # ####### ##### # ### ### ### ####### # ### # #
# # # # # # #     # # #   #     #   #     # #   # #   #   #   # #   #   #   #   #
### # # ### # # ##### ### # ### ##### ### # # # # ### # # ### # # # # ##### #####
#   # #     # # #     # # #   # # #     # #   #   # # # #   # # # #   #   # #   #
# ### ####### ### ##### # ##### # # ### ######### # ### ### # ### ####### # # # #
#   # #         #     # #       # # # #         #     #   # # #   #       # # # #
# # # # ####### ##### # ######### # # ### ##### ##### ##### # # ### # ##### ### #
# # # #   #   # #   # #         #   # #   #         #   #   #   #   #     # #   #
### # ### # # # # # # # ##### ### ### # ### ########### # # ##### ####### # # # #
#   # #     # #   # # #     # #   #   #   # #         #   # #   #     #   # # # #
# ### ####### ##### # # ### ### ### # ### ### ####### ##### # # # ##### ### # # #
#   #     #       # # #   # #   #   #   #   #   #   #     # # #   #   # #   # # #
### ##### # ####### # ### # # ### ### ##### ### ### # ##### ####### # # # ### ###
#     #   # #   #   #   # #       #   #   #         #       #   #   #   #   #   #
# ##### ##### # # # ### ### ######### # # ####### ######### # # # ######### ### #
# #   #   #   #   #   #   # #       # # #       # #   #   #   #   #     #   #   #
# # # ### # ####### ##### ### ##### # # ####### ### # # # ####### # ### # ### ###
#   #     # #       #   #   #   #   # # #     # #   # # #   #     #   #   #     #
# ######### ### ##### # ### ### # ### # # ### # # ### # ### # ####### ##### ### #
# #     #     #     # # #     # #   # #   # # #     # # # # # #     #     # # # #
# ### # # ### # ##### # # ##### ### ####### # ####### # # # # # # # ##### # # # #
#   # #   # # # #   # # #       # #         # # #     # # # # # # # #   # #   # #
### # ##### # # # # # # ######### ### # ##### # # ### # # # # ### # ### # ##### #
# # #       # # # #   #   #     #   # # #     # # #   # # # #     #   # #       #
# # # ####### ### ##### # # # # # # # ### ##### # ##### # # ######### # ####### #
# # # #     #         # # # # # # # #   # #     #     #   #     #   #   # #     #
# # # # ### # ######### ### # # ### ### # # ### ##### ### ##### # # ### # # #####
# # # #   # #   #     #     # # #     # #   #   #   #   # #   # # #       #   # #
# # ##### # ##### ### ####### # # ### # ##### ### # # ### # ### ######### ### # #
#   #     #       # #   #   # #   #   #     # #   # #     #   # #       #   #   #
# ### ############# ### # # # ##### ##### ### # ### ######### # # ##### ####### #
#     #                   #   #         #       #             #       #         #
######### #######################################################################

