# ###############################################################################
#     #       # #                   #         #           #   #       #     #   #
# ### ### ### # # ### ############# ### ##### # ######### # # # ##### # # ### # #
#   #   #   # # # # #       #     #     #   # #     #       # # #     # #     # #
# # ### ### # # # # ####### # # ######### ### # ### # ######### # ##### ####### #
# # # #     #   #     # #   # # #   #   #     #   # #     #     #     #   # #   #
# # # ######### ##### # # ### ### # # # # ####### # ### ### ######### ### # # ###
# # #             #   # # #       #   # #   #   # # # # #       #   #       #   #
# # ############### ### # ##### ####### ### # # # # # # # ####### # # ######### #
# #         #           #     #     #   # # # # # # #   # #       # # #       # #
# ######### # ######### ##### ####### # # # # ### # # ### # ####### # # ##### # #
# #       #   #   #   # #   #     #   #   # #     # # #   #   #   # # #   #   # #
# ### ### ##### # # # ### # ##### # ##### # # ##### ### ##### ### # ##### # ### #
# #   #   #     #   #     # #   # #     # # #   # # #   #   #   #       # # #   #
# # ### ### ############### # # # ##### # # ### # # # ### # ### ####### # # ### #
#   #   #   #   #     #   #   #   #   # # #   # # # #   # #   #     # # # #     #
######### ##### # ### # # ######### # # ##### # # # ### # ### # ### # # # ##### #
#     #   #     #   # # #   #       #   #     #   # #   # # # # #   # #   #   # #
# ### # ### ####### # # # ### # ### ##### ####### # # ### # # ### ### ##### ### #
#   #   #     #     # # #   # #   # #   #     #   # # #   #     # #             #
# # ####### # # ##### # ### # ### ### # ##### # ### # # ####### # ##### #########
# #       # #       #     #     #     #       #   #   #     #   #     #       # #
######### ######### ######################### ############# # ### ### ####### # #
#       #   #     #   #                     #           #   # #     # #     #   #
# ##### ### # ### ##### ################### ########### # ### ####### # ### ### #
# #         #   #             #       #   # #     #       #     #     # # #     #
# ######### # ######### ##### ##### # # # # # ### ############# # ##### # #######
#       #   # #       # #   #       # # # # # # #       #   # #   #   # #       #
# ##### ##### # ##### # # # ######### ### # # # ####### # # # ##### # # ##### # #
# #   #       # #     # # #         #     # # #       #   # #     # # #   #   # #
# # # ######### # ####### ######### ### ### # # ### ####### ### ### # ### # #####
# # #     #     #     #   #   #   # #   #   # #   # #       #   #   #   # #     #
# ####### # ######### # ### # # # # ### # ### ### # # ####### # # ##### # ##### #
#         # #         #     # # # #   # #       # # #   #     # # # #   #   #   #
### ####### ####### ######### ### ### # ####### # # ### # ##### # # # ##### # ###
#   #     # #     #           #   #   # #   #     # #   #     # # # #   #   #   #
# ### ### # # ### ############# # # ##### # ####### # ### ### ### # ### # ### # #
#   # # # #   #   # #           # #       #     # # #   # # #     # #   # # # # #
# ### # # # ### ### # ### ####### ############# # # ### # # ####### # ### # # # #
# #   #   #   #   #     # #   # # # #         # # # #   #     #   # # #   # # # #
### ### ####### # ##### # # # # # # # # ####### # # # ####### # # # # # ### # # #
#   # #   #   # # #   # # # # #     # #         #   #   #   # # #   #   # #   # #
# ### ### # # ### # # # # # # # ##### ########### ##### # # # # ### ##### # ### #
# #         #     # # # #   # #   #   #     #     #   # # # # # #     #   # # # #
# # ############### # # ##### ##### ##### ### ##### ### # # # # ##### ### # # # #
# #   #           # # #     # #     #     #   #       # # #     #   #   #     # #
# ##### ######### # # ####### # ####### ### ####### # # ######### # ### # ##### #
#     # #     # #   #       #   #       #   #     # # #           #   # # #     #
# ### # # # # # ########### ### # # ##### ##### # # # ############# # # ### ### #
# # # # # # #             #   # # #     # #     # # #   #   #     # # # #   # # #
# # # # # # # ##### ######### # # ##### # ### ### ### ### # # ### ### # # ### # #
#   #   # # # #   # #   #     # # #   #       #       #   # # #     # #   #     #
### ####### ### # # # # # ##### # # # ##### ########### ### # ##### # ##### #####
# #   #   #   # # # # # # #     # # #     # #   #       # # #   #   # #   # #   #
# ### # # ### # # ### # # # ####### ##### ### # # ####### # ### # ### # ### ### #
#       #     # #     #   #         #         #   #             #     #         #
##################################### ###########################################

