########### #####################################################################
#     #             #   #   #             #   #     #     #   #             #   #
# ### # ########### # # ### # ########### # # # # ### ### # # # ######### # ### #
#   # #   #       #   # #   #     #     #   #   # #     #   # #     #     # #   #
# # # ### ##### ####### # ####### # # ########### # ######### ##### # ##### # ###
# # #     #   #     #   #     #   # #         #   # #             # # #     #   #
### ####### # ##### # ##### # # ### ##### # ### # # # ############# # ### ##### #
#   #   #   #   #   #   #   # # #   # #   # #   # # #     #         #   #       #
# ### # # ##### # ##### # ##### # ### # ### # ### # ##### # ########### ####### #
# #   #   # #   #     # #       #     # # # # #   #   #   #           #       # #
# ### ##### # ##### ### # ########### # # # # ####### # # ####### ##### ##### ###
#   #     # # #     #   #   #     #   # #   #         # # #       #   # #   #   #
# # ##### # # ### # # ##### ### # # ### ##### ######### ### ####### # # # ##### #
# #   #   # #     # # #   #     # #   # #   #   #     #     #       # #   #     #
# ### # ### ##### ### # # ####### ##### # # ##### ### ####### ####### # ### ### #
# #   # #       # #   # #     #   #   # # #       #       #   #     # # #   # # #
### ### ### ##### # ### # ##### ### # # # ##### ######### # ### ### # # # ### # #
#   #     #       #   # # #     #   # # #     # #   #   # # #   # #   # # #   # #
# ### ### # ######### # ### ##### ### # ##### ### # ### # # # ### ####### ### # #
#   # #   # #     #   #     #   # # #       #     # #   #   #         #   #   # #
# # # # ##### ### # ####### # # # # ### ##### ##### # ############### # ### # # #
# # # #   #   # # # #     #   #   #     #   # #     # #             #   #   # # #
# # ##### # ### # # ### # ######### ##### # ### ##### # ####### ### ##### # ### #
# #     #   #   # #   # #     #       #   # #   #   #   #     # # #     # #   # #
####### # ##### # ### # ##### ### ##### ### # ### # # ### ### # # ##### # ### # #
#     # #   #   #   #   #   #   #   #   # # #   # #     #   #   # #     #   #   #
# ### # ### # # # ####### # ### ##### ### # ### ####### ### ##### # ####### #####
#   #   #     # # #     # #   # #     #   # #   #   #   # # #     #     #   #   #
### ############# # ### # # ### # ##### # # # # # # ### # # ### ####### # ### # #
#   #           #     # # #     # #     # #   # # #   #   #   #   #     #   # # #
# ### # ####### ##### # # ####### ##### # ##### # ### ####### # # # ####### # ###
# #   # #     #   #   # # #           # # #   # # #   #     # # #     #   # #   #
# ##### # # ##### ##### # # ####### # ### # # # # # ### ### # ####### ### # # # #
#   #   # #     #     # # # #     # #   #   #   # # #   #   #       #     # # # #
### # ######### ##### # # ### ### ##### ######### # # ### ### ##### ####### # # #
#   #   #     #     # # #     #   #   # #         # #   # #   #   #     #   # # #
# ### # # ### # # ### # ####### ### # # # ######### ### # ### ### ##### # ##### #
# # # #   #   # #       #     #     #   #   #   #   # # #   # #     #   # #     #
# # # ##### ########### # ### # ####### ### # ### # # # ### # # ### # # # # #####
# #   #   #   #     #   # # #   #     #   # # #   #   # # # # #   # # # # # #   #
# ### ### ### # ### ##### # ##### ### ### # # # ####### # # # ### ### ### # # # #
#   #       # #   #     # # #   # #   # # #   #   #     # # #     #   #   #   # #
# # # ####### # ##### # # # # # # # ### # # ##### # ##### # ####### ### ####### #
# # # #     # # #   # #     # # # # # #   # #     #   #   # #     #     #       #
# # ### ### # # # # ### ##### # # # # # ### # ####### # # # # ### ### ### # ### #
# # #   #   #   # #   # #     #   # # # #   #       # # # #     #   # #   # #   #
# # # ### ####### ### ### ######### # # # ####### # # # ########### # # ### # ###
# # #   #     #   # # #   #     #   #   #   # #   # # #     #       # #   # # # #
# # ### ##### # ### # # ##### ### ### ##### # # # ### ##### # ####### ##### # # #
# #   #     #   #   # #     #   #   # #   # # # # #   #     # #     #     # #   #
# # ####### ####### # ##### # # ### # ### # # # ### ### ### # # ######### # #####
# #       # #       #     # # # #   #     #   #   # #     # # #       #   #     #
# ### ### # ### ##### ##### ### # ########### ### # ### # ### # ##### # ####### #
# # # #   #   #   #   #   #     #   #       # # # #   # #   # #     # # #   #   #
# # # ####### ### # ### # ##### ### # ### ### # # ### ##### # ##### # # # # # # #
#   #             #     #         #     #       #           #     # #     #   # #
################################################### #############################

