######################################### #######################################
#       #   #                       #         #     #   #   #     #       #     #
# # ##### # # ############# # ##### # ##### # # ### # # # # ##### # ##### # #####
# #   #   # #   #     #   # # #     # #   # #   #   # # # #       # # #   #     #
##### # ### ### # ##### # ### ####### # # # ##### ### # # ##### ### # # ### ### #
#   # # # #   # #     # #     #   #     # # #   #   # #   #     #   #   #   #   #
# # # # # ### # ### # # ####### # # ####### ### ### # ####### ### ### ##### # # #
# #   #     # #   # # #     #   # #   #   #   #   #   #     #   #   #     # # # #
# # ### ##### ### # # ##### # ### ### # # ### # # ### # ### ####### ##### ### # #
# # #   #       # # #     # #   #     # # #   # # #   #   #         #   #   # # #
# ### ### ####### # ##### # ### ####### # # ##### # ##### ########### # ### # ###
#   #   #       # #   #   #     #   #   #   #   #   #     #           # # # #   #
### ### ####### # # ### # ######### # ####### # ### # ####### # ####### # # ### #
#   #     #     # # #   # #         #     #   #   # #       # #   #       #   # #
# # # ##### ##### # # ### # ##### ####### # ##### # ####### # ### ####### ### # #
# # # #     #     # #   #   #   # #       # #   # #     #   #   #     #     # # #
# # # # ### # ####### # # ### # # # ##### # # ### ### ### ##### ##### ##### # # #
# # # #   # #   #   # # # #   # # # # #   # #   #   # #   #     #   #     # #   #
# ### ### ##### # # # # ### ### # # # # ### ### ### ### ### ##### ####### # ### #
#     # #     #   # # #     #   # # #     #     #   #   # # #   #     #   # # # #
# ##### ##### ##### ######### ##### # ######### # # # ### # # # ### # # ### # # #
#   # #     #     #   #     # #   # # #       # # # #   # # # #   # # # #   # # #
### # # ### ### ##### # ### # # # # ### ### ### # # ### # # # ### ### # ### # # #
# # # #   #   # #     # # # #   # #   #   # #   # # #   # # #   #     #   #   # #
# # # ### ### # # ##### # # ##### ### ### # # ### ####### # ### # ####### ### # #
# # # #   #   #   #   # #           #     # #   #   #       #   # #       #   # #
# # # # ### ####### # # ### ############### ### ### # ####### ### # ####### ### #
#   #   #   #       # #   # #   #         #   # # # #         #   #       # #   #
# ### ### # # ##### # ### ### # # ####### ### # # # ### ##### ########### ### ###
# #     # # #     # #   # #   #   #   #   #   #   #     #   # #         #   # # #
# ##### # ####### # ### # # ####### ### # # ##### ####### # ### ####### # # # # #
#     # #     #   #   #   #         #   # #             # #   #       # # # #   #
##### # ##### # ##### ### ##### ##### ### ############# # ### ####### # ### ### #
#   # # #   # #   # #   # #   # #   # #   # #     #   # # # #         #   # #   #
# ### # # # # ### # ### ### # # # # # # ### # # # # # ### # ############# # # ###
# #   # # # #   # #   #   # #   # # # #   #   # # # #     # #         #   # # # #
# # ##### # ### # ### ### # ##### # # ### ##### # # ####### # ##### ### ### # # #
#   #     #   # # #     #   #   # # # # # #     # # #   #     #   #   # #   # # #
# ### ####### # # # ### ##### # # # # # # # ##### # # # ####### # ### # # # # # #
# #   #     # #     # #   #   #   # # # #   #   # #   #         #   #     # #   #
# # ### ### # ####### # ### ####### # # ##### # # ################# ####### ### #
# #     #   #     #     #   #   #     # #     # # #           #   #   #     #   #
# # ##### ####### # ##### ### # ####### # ### # # ### # ##### # # ### # ##### ###
# # # #   #     # #     #   # #     #     # # # #   # # #     # #   # #   # # # #
# # # # ### ### # ######### # ##### ### ### # ##### # # ### ##### # # ### # # # #
# #   # #   # # #         # # #   #   #   # # #     # #   #     # # #   #   #   #
# ##### # ### # ######### # # ### ### ### # # # ##### ### ##### ### ### ### ### #
#       # #   #       #   # # #   #   #     # #   # #   # #     #   # # #   # # #
######### # ### ### ### ### # # ### ### ##### ### # ### # ##### # # # # ### # # #
#     #     #   # # #   #     # #   #   # #     # #     #     #   #   #   #   # #
# ### ##### # ### # # ####### # # ### ### # ##### ####### ### ####### ### ### # #
#   # #   # #   #   # #     #   #   # #   #     #       # #   #     # # # #   # #
### # # # ##### # ### # ### ####### # ### ##### ####### ### ### # # # # # ### # #
#   #   #       #   #   # #       # #   #   # #       # #   # # # # # # #   # # #
# ####################### ####### # ### # # # ### ##### # ### # # ### # ### ### #
#                                   #     #     #         #     #         #     #
################################################### #############################

