################################# ###############################################
#   #     #       #   #     #             #   #           #   #       #     #   #
# # # # ### # ### ### # ### # # ######### ### # ####### # ### # ##### # ### # ###
# # # #     # # #   # # # #   #     #       # #   #   # #     # #   #   #   #   #
# ### ####### # ### # # # ######### ####### # ### # ### ##### # # # ##### ##### #
#         #   #   # # #       #   #     #       # # #   # #   # # #   #   #   # #
######### # ### ### # ####### ### ##### ######### # # ### # ### ##### # ### # # #
#   #     #   #     # #       #   #   # #         # # #   # #   #   # # #   # # #
# # ######### # ##### # ####### # # ### # ######### # ### # ##### # # # # ### # #
# #     #     #       #         # # #   # #         #   # #   #   #   #   # # # #
# ##### # ####################### # # ### ##### # ##### # ### # # ######### # # #
#     # #     #   #         #   # # # #   #     # #     #     # # #     # #   # #
# ### # ##### # # # ####### # # # # # # ### ####### # ####### # # # # # # # ### #
# # # #   #   # #   #       # #     #       #       # #     #   # # # #   #   # #
# # # ### # # # ##### ### ### ############# # # ####### ### ##### # # # ##### # #
# # # # #   # #   # #   # #   #     #     # # # #   #   #   #     # # # #   # # #
# # # # ##### ### # ### ### ### ### # ### # # # # # # ### ######### # # # # # # #
# # # #       # #   # #     # #   #   # # # # # # #     #           # # # #   # #
# # # # ####### ### # ####### ### ##### # ### # # ################### # # ##### #
#   # # #     # #   #   #     # # # #   #     # # # #                 # #   #   #
# ### # # # # # # ##### # # # # # # # # ##### ### # # ################# ### ### #
# #   # # # #   # #   #   # # # # #   #       #     #   #   #   #     #   # #   #
### ### ### # ### # # ### # # # # ### ####### # ####### # # # # # ### # ### # # #
#   #       # #   # #   # # #   #   # #     # # # #   # # #   #   # #   #   # # #
# ### ##### ### ### ### ### ### ### ### ### ### # # # # # ######### ##### ### ###
# #   #   # #   #     #     # # # #     # #     # # #   #     #     #     #     #
# ##### # # # ### ### ####### # # ####### ####### # ######### ##### # ##### ### #
#       # # #   # # # # #       #       #       # #     #           # # #   #   #
# ####### ##### # # # # # ##### ##### # ##### # # ##### ####### ##### # # ### # #
#   #   #       #   # #   #   #   #   #   #   #   # #   #   #   #   # # # # # # #
### # ############### ##### # ### # ##### # ##### # # ### # ##### # # # # # # # #
#   #               # #     #   #   #     #     # # #     #       # # #   # # # #
# ##### ##### ##### # # ####### ##### ######### # # ############### # # ### # ###
#     #     #   # # # # # #   # #   #   #       #   #           # # # #   # #   #
##### ### ##### # # # # # # # # # ##### # ######### # ####### # # # # ### # ### #
# #   #   #     #   #     # #   #   #   #     #   # #   #   # #   # # #     #   #
# # ### ### ##### ######### ####### # ####### # # # # ### # # ### # # # ##### # #
#   #   # #   # #         # #       # #       # #   # #   # # # # #   # #     # #
# ##### # ### # ### ##### # # ####### ### ##### ####### ### # # # ##### # ##### #
#     # #   # #   # #   # # # #     #     # #   #       #   # #   #   # # # #   #
##### # # ### # ### # # # # # # ### ####### # ### # ##### ### # ### # ### # # ###
# #   # #   # #     # # #   #   # #   # #     #   # #     #   #     #   # #     #
# # ### ### # ####### # ##### ### # # # # ##### ### # ##### ########### # #######
# # # #     #     #   # #   #   # # #   # #       # #   #     #     #     #     #
# # # ##### ##### # ### # # ### # # ### # ####### # ### ##### # ### ####### ### #
# # #   #       # # #   # #   #   #   # #       # # #   #     #   #   #       # #
# # # ### ####### # # ### ### ####### # ####### # # # ### ####### ### # ####### #
# # #     #     #   #   #   # #       # #     # # # #   #   #     #   # #       #
# # ####### ### # ##### ### # # ####### # ### # # # ### ### # ##### ### # ##### #
# #         # # # #     #   #   #   #   #   #   # #   #   #   #   #     #   #   #
# ########### # # # ##### ####### # ### ### ##### ### ### ##### # ##### ### # ###
#       #     # # #   #           #   # #   #     #   # #   #   # #   #   # # # #
### ##### # ### # ### ####### ####### ### ######### ### ### # ### # # ##### # # #
#   #     #   # #   #       #       # #   #   #     # #   #   # # # #     # #   #
# ### ####### # ########### ####### # # ### # # ##### # # ##### # # ##### # ### #
#           #               #       #       #   #       #           #       #   #
######################### #######################################################

