########################### #####################################################
# #   #             #   #   #                   #       #             #   #     #
# # # # ##### # ##### # # # # ### ########### ### ### # ########### # # # ##### #
# # #   #   # # #     # # #     #   #         #   # # #     #       # # #     # #
# # ##### ### ### ##### # ######### ####### ### ### # ##### # ####### # ##### # #
# # #   #   #   # #   # # #       #       #   #     # # #   # #     # #     # # #
# # # ### # ### # # ### ### ##### # ##### ####### ### # # ### # ##### # ### # # #
#   #     #   #   #   # #   #   # # #   #   #     #   #     # #       #   # #   #
# ######### ######### # # ### ### ### # # # # ##### ####### # ### ######### ### #
#         #   #       #       #   #   # # #   #     #   # # #   #           #   #
######### # # # # ### ######### ### ### ##### # ### # # # # ### ############# ###
# #       # # # # #     # #     #   # #     # # #   # # #   #   #           #   #
# # ####### # # # ##### # # ##### ### ##### ### ### # # # ### ### ############# #
#   #     # #   #   #   # #     #     #   #   #   # # # #     #               # #
# ### # # # ####### # ### ##### ##### # ##### ### ### # ####### ########### # # #
# #   # # # # #   # #         #     # #     #   #     # #     #         # # # # #
# ##### ### # # # # ####### ##### # # ##### ### # ##### # # # ######### # # # # #
#     # #     # #   #     # #     # #       #   # #   # # # #     #   #   # # # #
##### # # ##### ### # ### ### ### ##### ##### ### # # # # # ##### # # ### # ### #
#   # # # #     #   #   #     #   #     #   #   #   # # # #     #   # #   # #   #
# ### # # # ##### ##### ########### ##### # ### ##### # ####### ####### ### # ###
#   # #   # # #   #   #             #     #   #   #   #       #         # # # # #
### # ##### # # ### ################# ####### ### # ######### # ######### # # # #
#   #     # # #   # #   #           # # #     #   #         # # #         #   # #
# ####### # # ### # # # # ##### ##### # # ##### ##### ####### # ### ########### #
# #     # # #   # #   # # #   # #     # # #   # # #   #       #   #             #
# # # ### # # # # ##### # # # # # ##### # # # # # # ### ######### ### ##### ### #
#   #   #   # #   #   # # # #   #   #   #   #   #   #   #       #   #     #   # #
# ##### ##### ##### # # # # ### ##### ############### ######### ### ##### ### # #
# #   #     # #     # # # # #   # #   #       #     #         #   #     #   # # #
# # # ### ### ### ### # # # # ### # # # ##### # # # ##### ### ### ##### # ### # #
# # #   #   #     #   #   # # #     #   #   #   # #     #   #   #       # #   # #
# # ### ### ####### ####### # ########### # ##### ##### ##### # ### ##### # ### #
#   #   # #       # #       #       #   # #     # #     #   # #   #   #   #   # #
##### ### ##### # # ### ########### # # # ##### # ##### # # ##### ### # ##### ###
# #   #   #   # # # #   #         #   # #   #   #     #   #       #   #     #   #
# # ### # # # # ### # ##### ########### ### # ####### ############# ### ####### #
# #     # # # #   #   #   #         #   #   #         #           #   # #       #
# ####### ### ### ##### # ####### # # ### ############# ####### # ### ### ##### #
#     #   #     #       #         # #   #   #   #     # # #     #   # #   #   # #
# ### # ### ### ##### ####### ######### # # # ### # ### # # ####### # # ##### # #
# #   #     #   #   # #       #     #   # # #   # #   # # #       # # # #     # #
### ######### ### ### ######### ### # ##### # # # ### # # ####### ### # # # # # #
#   #         #     # #       #   # # #     # #   #   # #       #   #   # # # # #
# ### ############# # # ##### ### # # # # ######### # # # ##### ### ####### # # #
#   #   #           #       #   # #   # #     #   # # # #     #   #     #   # # #
# # ### # ##### ### ########### # ########### # # # ### # ##### # # ### # ##### #
# #     #   #   #     #         #   #       #   # # #   # #     # #   #   #     #
# ########### # ####### ####### ### # ##### ##### # # ##### ### ##### # ### #####
# #           # #       #     #   #   #   # #     #   #   #   # #   # # #   #   #
# ##### # ### ### ####### ### ### ##### ### # ##### ### # # # ### # # ### ##### #
#     # # # # #   #     #   #     #       #   #     #   # # #   # # #   #       #
##### # # # # # ### ####### ##### # ##### ##### ##### ### # ### # # ### ####### #
#   # # # # # #   #         #   # # #   # #     #     #   # #   # #     #   #   #
# ### ### # # ### ########### # ### # # # # ######### # ##### # # ####### # # ###
#         #     #             #       # #             #       # #         #     #
####################### #########################################################

