################################################### #############################
#                                                                               #
# # # # # ############# ##### ### # # # # # ### # # ### ##### # ### ### ####### #
# # # # #             #     #   # # # # # #   # # #   #     # #   #   #       # #
# ########### ### ### ########### # # # ### ### ### ### # # # # # ####### ### # #
#           #   #   #           # # # #   #   #   #   # # # # # #       #   # # #
# # # # ### # ### ########### # # # # ### # # # # # ##### ### ### ####### ### # #
# # # #   # #   #           # # # # #   # # # # # #     #   #   #       #   # # #
# # # # ### ### # ### # ######### ### # # ### # # # # # ### ##### # ##### ##### #
# # # #   #   # #   # #         #   # # #   # # # # # #   #     # #     #     # #
# # # ####### # ### ### ##### # ### ### # # ####### ### # ####### # ### ##### # #
# # #       # #   #   #     # #   #   # # #       #   # #       # #   #     # # #
# ##### # ### ### ### # # # ####### # # # ### ### # # # ### # ###################
#     # #   #   #   # # # #       # # # #   #   # # # #   # #                   #
# # ### ##### ########### ### ####### # # ##### # # ####### ### ##### ######### #
# #   #     #           #   #       # # #     # # #       #   #     #         # #
# # # # # # # ########### # # # # ### ################# # # # # ####### # #######
# # # # # # #           # # # # #   #                 # # # # #       # #       #
# # ##### ##### ########### # ### ### ##### ### # ##### ##### ### ### # ##### # #
# #     #     #           # #   #   #     #   # #     #     #   #   # #     # # #
# ####### ### ### ### ### # # # ### # ##### # ####### # ### # ### # # ### ### # #
#       #   #   #   #   # # # #   # #     # #       # #   # #   # # #   #   # # #
# # # ####### # ##### ### # ##### # ##### # ### # ##### # ### # ### # ### # # ###
# # #       # #     #   # #     # #     # #   # #     # #   # #   # #   # # #   #
# # ####### # # ####### # # ### # # # # # ########### ####### # ############# # #
# #       # # #       # # #   # # # # # #           #       # #             # # #
# # ### ### ### # ##### # # ####### # # ##### ### # ##### ####### ### ### ### # #
# #   #   #   # #     # # #       # # #     #   # #     #       #   #   #   # # #
# ### ####### # # ######### # # # # ### ##### # ############### # ####### ### # #
#   #       # # #         # # # # #   #     # #               # #       #   # # #
# ### # ### # ##### # ### ####### # # # ### # # ##### ### ### # # ##### # # # ###
#   # #   # #     # #   #       # # # #   # # #     #   #   # # #     # # # #   #
# # ### ####### ####### # # ### # # # ### ### # ##### ### # ### # ##### # ### ###
# #   #       #       # # #   # # # #   #   # #     #   # #   # #     # #   #   #
# ##### ### # ####### ### ### ############### # ### # # ##### ##### # ##### # # #
#     #   # #       #   #   #               # #   # # #     #     # #     # # # #
# ### # ########### ### ### # # # ######### # # # # # # ##### # ##### # # ### # #
#   # #           #   #   # # # #         # # # # # # #     # #     # # #   # # #
# ### ### # ####### # ### ### ######### ######### # # # # ### # ##### # # #######
#   #   # #       # #   #   #         #         # # # # #   # #     # # #       #
# # # # ######### # # ### # ### ##### ########### # # # ### ### # ####### ##### #
# # # #         # # #   # #   #     #           # # # #   #   # #       #     # #
# # ### # # ######### ########### ### # ### # # ##### # # ### ### # ### # #######
# #   # # #         #           #   # #   # # #     # # #   #   # #   # #       #
# ### ### # # # ####### # # # # # # # # ########### ### # ##### ### # # # #######
#   #   # # # #       # # # # # # # # #           #   # #     #   # # # #       #
# ### # ### ### ### ### ######### ### # # # # ####### # ### # # # ####### # # # #
#   # #   #   #   #   #         #   # # # # #       # #   # # # #       # # # # #
# ### # # ##### ######### # ### ### ##### ######### ### ##### ### # ### ### #####
#   # # #     #         # #   #   #     #         #   #     #   # #   #   #     #
# ################### # ### # ### ### # # ### ##### ### # # ####### ##### # # # #
#                   # #   # #   #   # # #   #     #   # # #       #     # # # # #
# # ### ### ##### ##### # ####### # # # ######### ### ### ##### # ### # ##### ###
# #   #   #     #     # #       # # # #         #   #   #     # #   # #     #   #
######################################################################### #######

