############### #################################################################
#                                                                               #
# ### ##### # ### # ####### ### # ##### ### ######### # ##### ##### # ##### # ###
#   #     # #   # #       #   # #     #   #         # #     #     # #     # #   #
# ### # # # ### ##### # # # # ### # ### # # ### ### ### # ### ### # # ### ### # #
#   # # # #   #     # # # # #   # #   # # #   #   #   # #   #   # # #   #   # # #
# ####### ####### # ##### ### # # # # # # # # # ### ### ######### # ####### ### #
#       #       # #     #   # # # # # # # # # #   #   #         # #       #   # #
# ### # # # # ####### # ####### ### ##### ####### # ##### ####### # ##### ### ###
#   # # # # #       # #       #   #     #       # #     #       # #     #   #   #
# ####### ### ### # ### # ### ### # # # ######### # # ### # # # # # ### # # # ###
#       #   #   # #   # #   #   # # # #         # # #   # # # # # #   # # # #   #
# ##### ### ### # # # # # # # # # # # # # ##### ######### # ####### ### # ##### #
#     #   #   # # # # # # # # # # # # # #     #         # #       #   # #     # #
# ### ### ##### # # ##### ######### ####### ####### ### ### # ######### # # # # #
#   #   #     # # #     #         #       #       #   #   # #         # # # # # #
# # # ### # # ##### # # ### # # # # ##### ##### ##### # ### ### # # ####### ### #
# # #   # # #     # # #   # # # # #     #     #     # #   #   # # #       #   # #
# # ### # # ### # ### # # ####### ##### # ####### # # ##### # ##### # ##### # ###
# #   # # #   # #   # # #       #     # #       # # #     # #     # #     # #   #
# ### ### # # ### # # # ##### ### # ### ##### # # ### # ######### ### ### #######
#   #   # # #   # # # #     #   # #   #     # # #   # #         #   #   #       #
# # ### ### ######### ####### # # ### # # # ######### # ### # ### ### ### # ### #
# #   #   #         #       # # #   # # # #         # #   # #   #   #   # #   # #
# ####### # # # # ######### # ### # # # ########### ############# ### # # ##### #
#       # # # # #         # #   # # # #           #             #   # # #     # #
# ####### ### ### ### # # ##### ########### ############### ### # # # # # #######
#       #   #   #   # # #     #           #               #   # # # # # #       #
# ### ### ### ##### ##### ### # ####### # ############# # ### # ### # # ####### #
#   #   #   #     #     #   # #       # #             # #   # #   # # #       # #
# # # ### # ##### # # # ####### # ### # # ### # # # # # ### ### # # ### ##### ###
# # #   # #     # # # #       # #   # # #   # # # # # #   #   # # #   #     #   #
# # ### # ################# ### # ####### ############### # # # # ####### ##### #
# #   # #                 #   # #       #               # # # # #       #     # #
# # ### # # # ### # ### # # # # # # # ####### ##### ######### # # # #############
# #   # # # #   # #   # # # # # # # #       #     #         # # # #             #
# # # ####### # # ### # # # # ##### # ####### ####### # ##### # # # ##### ### # #
# # #       # # #   # # # # #     # #       #       # #     # # # #     #   # # #
# ### # # ### # ### ##### ########### # ##### ### ### # ##### ### # ### ####### #
#   # # #   # #   #     #           # #     #   #   # #     #   # #   #       # #
# ### # ##### # # # # ######### # # # # # # # # ##### # # ### ############### # #
#   # #     # # # # #         # # # # # # # # #     # # #   #               # # #
# ################# # # ### # # ####### # # ##### # # # ### ##### # ### ### # # #
#                 # # #   # # #       # # #     # # # #   #     # #   #   # # # #
# # # ### ### ### ##### ##### # ######### ### ### # ### ### ######### ### # # # #
# # #   #   #   #     #     # #         #   #   # #   #   #         #   # # # # #
# # ############### # ### # # # # ######### ############# ##### # ##### ### # # #
# #               # #   # # # # #         #             #     # #     #   # # # #
# ### # # # ### ##### # # ### ##### ### ### # # ### ### ### # ##### ####### #####
#   # # # #   #     # # #   #     #   #   # # #   #   #   # #     #       #     #
# # # # # ######### ### ### ### ### # # ### # # # # ######### ### ### ### ### ###
# # # # #         #   #   #   #   # # #   # # # # #         #   #   #   #   #   #
# ### ### # ####### ### ####### # ### # ### ############# ##### ##### # # # #####
#   #   # #       #   #       # #   # #   #             #     #     # # # #     #
# ####### ### ##### # # # ##### # ### ### # # # # # ######### # ### # ### ##### #
#       #   #     # # # #     # #   #   # # # # # #         # #   # #   #     # #
############################################# ###################################

