######################################################### #######################
#                                                                               #
# # # # # # # # # # ### # # # ##### # ##### # # ######### ### # # # ### ### # ###
# # # # # # # # # #   # # # #     # #     # # #         #   # # # #   #   # #   #
# ####### ####### # ### ######################### ##### # # ### # ############# #
#       #       # #   #                         #     # # #   # #             # #
# # # # ### ### # ### # ### # # # # # # ############### # ### # # # # # ##### # #
# # # #   #   # #   # #   # # # # # # #               # #   # # # # # #     # # #
# # ##### ##### ##### ##### ####### # # ##### # # ### ####### # # # ##### ##### #
# #     #     #     #     #       # # #     # # #   #       # # # #     #     # #
# ######### ### # ################# # # ### ### ### ######### # ##### ### ### ###
#         #   # #                 # # #   #   #   #         # #     #   #   #   #
# ### # # # # ####### ##### ##### # # ############# # ####### # # ##### ##### ###
#   # # # # #       #     #     # # #             # #       # # #     #     #   #
# ### # ### ### ### # ##### # # # ########### # # # # ####### ### ### # # #######
#   # #   #   #   # #     # # # #           # # # # #       #   #   # # #       #
# ### ### # ### ##### ### # # # # ##################### # ##### ######### ### # #
#   #   # #   #     #   # # # # #                     # #     #         #   # # #
# ##### # ##### ##### ### # # ### ### ### ##### ####### # ### ######### # # # ###
#     # #     #     #   # # #   #   #   #     #       # #   #         # # # #   #
# # # ### ### # # ### # # ########### # # # ### ############# ### ### # #########
# # #   #   # # #   # # #           # # # #   #             #   #   # #         #
# # ### ### # ######### ######### # # ####### ##### ### # ### # # ### # # # ### #
# #   #   # #         #         # # #       #     #   # #   # # #   # # # #   # #
# ### ### ######### # ### # ### # ### ##### ### # ### # # # ### # # # ### # #####
#   #   #         # #   # #   # #   #     #   # #   # # # #   # # # #   # #     #
# ### # # # ##### # # ######### # # ##### # # ####### # ########### # # #########
#   # # # #     # # #         # # #     # # #       # #           # # #         #
# ##### ##### ##### # # ##### ######### # ######### ### ### ####### # ### ##### #
#     #     #     # # #     #         # #         #   #   #       # #   #     # #
# # ####### # # ##### ### ######### # ##### ### ### ### ##### # # # ### # ### ###
# #       # # #     #   #         # #     #   #   #   #     # # # #   # #   #   #
# # ### ### ##### # # # # # # # # ####### # ####### # # ### ######### ### ##### #
# #   #   #     # # # # # # # # #       # #       # # #   #         #   #     # #
# ### ##### # # # ########### ####### # # # # ######### ####### ##### ### ### ###
#   #     # # # #           #       # # # # #         #       #     #   #   #   #
# ##### # # ######### ### ################### ##### # ####### # # # # ### # # # #
#     # # #         #   #                   #     # #       # # # # #   # # # # #
# # # ####### # # ############# ### # # ### ##### # # # # # # # # # # # # ##### #
# # #       # # #             #   # # #   #     # # # # # # # # # # # # #     # #
# # # ### ### ####### # ##### ##### ### # ##### ##### ### # # ### ####### ##### #
# # #   #   #       # #     #     #   # #     #     #   # # #   #       #     # #
# ####### # ### # ######### # ### # # # # # ####### # ### ### ### # ### # # ### #
#       # #   # #         # #   # # # # # #       # #   #   #   # #   # # #   # #
# ##### # ### ##### ### # # # # # # ####### # ##### # # # # ### # # # # # ### # #
#     # #   #     #   # # # # # # #       # #     # # # # #   # # # # # #   # # #
# # ### ######### ####### ####### # # # ##### ########### # # # ######### ### # #
# #   #         #       #       # # # #     #           # # # #         #   # # #
# # # ### # ### # ######### # # ##### # # # ### ### # ####### # ### # # #########
# # #   # #   # #         # # #     # # # #   #   # #       # #   # # #         #
# # # # ####### # # ##### ### ### # ##### ### # ##### # # ### # ### # ####### ###
# # # #       # # #     #   #   # #     #   # #     # # #   # #   # #       #   #
# ### # ####### # # ### # # ##### # ##### ##### # # # # ### # # # ### ### #######
#   # #       # # #   # # #     # #     #     # # # # #   # # # #   #   #       #
######################################################### #######################

