####################################################### #########################
#                                                                               #
# ### ### ##### ### ######### # # ########### ### # ### ##### ### # ##### # #####
#   #   #     #   #         # # #           #   # #   #     #   # #     # #     #
# # ### # # # ##### # # ### ### # ####### ### ############# ##### # # ###########
# #   # # # #     # # #   #   # #       #   #             #     # # #           #
# ######### ### # ##### # ### # ### ### # # # ####### ######### # ### ####### # #
#         #   # #     # #   # #   #   # # # #       #         # #   #       # # #
# # # ##### # ##### ### ### # # # # # ### ##### ####### ### # ##### # ##### # ###
# # #     # #     #   #   # # # # # #   #     #       #   # #     # #     # #   #
# ### ### ### # # ### # ##### # # # ##### # # # # # ####### ######### # # # #####
#   #   #   # # #   # #     # # # #     # # # # # #       #         # # # #     #
# ######### ### ####### # ##### # ### ### # ### # # # # ### # ##### ### ### # # #
#         #   #       # #     # #   #   # #   # # # # #   # #     #   #   # # # #
# # ### # # # ####### # ### ### ### ##### ### # # # ######### # ### # # ### # ###
# #   # # # #       # #   #   #   #     #   # # # #         # #   # # #   # #   #
# ### # ### ### # # ##### # # # ##### ### ### ### # # ##### ##### # ####### # ###
#   # #   #   # # #     # # # #     #   #   #   # # #     #     # #       # #   #
# ### # # # ### # # # # ### ######### # # ######### # ### ####### ### ### ##### #
#   # # # #   # # # # #   #         # # #         # #   #       #   #   #     # #
# # ### # # # # ####### ##### # ##### ### ### ######### ####### # # # # # #######
# #   # # # # #       #     # #     #   #   #         #       # # # # # #       #
# ### ##### # # ####### ### ################# ######### # ############### # #####
#   #     # # #       #   #                 #         # #               # #     #
# # # # ### ### ####### # ################# ### # # # ### # ##### # ### ### ### #
# # # #   #   #       # #                 #   # # # #   # #     # #   #   #   # #
# ### # ### # ### # # # # ##### # ##### ### ##### # ### # ########### # ### ### #
#   # #   # #   # # # # #     # #     #   #     # #   # #           # #   #   # #
# # # ### # ### ### # # ####### ### ##### ##### ### ### ######### # # ### # # # #
# # #   # #   #   # # #       #   #     #     #   #   #         # # #   # # # # #
# ####### # # # # # # # ######### ### # # ######### ######### # ####### ### #####
#       # # # # # # # #         #   # # #         #         # #       #   #     #
# ### ### ########### # # # # # ##### ##### ##### ######### ########### # # # ###
#   #   #           # # # # # #     #     #     #         #           # # # #   #
# ### # ##### # ### ### ### ### ####### ### # ##### ### ### ### # ### ###########
#   # #     # #   #   #   #   #       #   # #     #   #   #   # #   #           #
# ######### ########### # # ### # # ### # ##### # # ####### ##### # # ### # #####
#         #           # # #   # # #   # #     # # #       #     # # #   # #     #
# # ######### ### # # # ### # ####### ### ##### # ### ##### # ### ### ##### # # #
# #         #   # # # #   # #       #   #     # #   #     # #   #   #     # # # #
# ### # ##### # ######### ### # ######### ############# # # # ##### # ### ##### #
#   # #     # #         #   # #         #             # # # #     # #   #     # #
# # # ### # # # # ### # # ##### # ####### ##### # ##### # # # # # ### ### # ### #
# # #   # # # # #   # # #     # #       #     # #     # # # # # #   #   # #   # #
# ### # ### # ### # # ####### ### ######### # ### ##### # # ##### # # ### # # ###
#   # #   # #   # # #       #   #         # #   #     # # #     # # #   # # #   #
# ##### ### # # # ### ##### # ### # ##### ####### ### ### ############# # # #####
#     #   # # # #   #     # #   # #     #       #   #   #             # # #     #
# ### # # # ##### ### # ####### # # # ######### ####### ### # # ##### # ### #####
#   # # # #     #   # #       # # # #         #       #   # # #     # #   #     #
# ### ### ######### ##### ############### ### ##### ####### # # # # # # ### # ###
#   #   #         #     #               #   #     #       # # # # # # #   # #   #
# ### ### # ####### ### # # ############# # # ### # ######### ### # ##### # # # #
#   #   # #       #   # # #             # # #   # #         #   # #     # # # # #
####################################### #########################################

