####################################################################### #########
#                                                                               #
# # # ######### ### ##### ### ##### # ### # ### ### # # ### # ##### # ##### #####
# # #         #   #     #   #     # #   # #   #   # # #   # #     # #     #     #
# ### # # # ### # # ### ### ### ####### # # ### # ####### ### # ### ### ### # # #
#   # # # #   # # #   #   #   #       # # #   # #       #   # #   #   #   # # # #
# # # # ##### # # ### # # ### ####### ####### ##### ####### # ##### ### ##### # #
# # # #     # # #   # # #   #       #       #     #       # #     #   #     # # #
# ##### ### ### ### ##### ### ##### # # # ##### # # ### # ### # # # ### ##### ###
#     #   #   #   #     #   #     # # # #     # # #   # #   # # # #   #     #   #
# # ##### ######### ##### ### ##### ### ########### # # # # ##### # ### # ### # #
# #     #         #     #   #     #   #           # # # # #     # #   # #   # # #
# ##### ##### ### ### # # ### # ### # ##### ### # # ### # # ####### ### # ### ###
#     #     #   #   # # #   # #   # #     #   # # #   # # #       #   # #   #   #
# # ### ### ####### # ### # # # ##### ##### ##### # # # ########### ### # # # # #
# #   #   #       # #   # # # #     #     #     # # # #           #   # # # # # #
# ### # ### # # # ### ##### # # # # # # ### ####### ### # ### ### ##### # ### ###
#   # #   # # # #   #     # # # # # # #   #       #   # #   #   #     # #   #   #
# ### ##### # # # # ### # # # ####### ### # ### # # ####### ##### ##### ##### ###
#   #     # # # # #   # # # #       #   # #   # # #       #     #     #     #   #
# # # # # ############### # # # ### # # ########### ### # # # ### ######### #####
# # # # #               # # # #   # # #           #   # # # #   #         #     #
# ##### # # ### ##### ##### ### ##### ######### ####### ####### # # ####### # # #
#     # # #   #     #     #   #     #         #       #       # # #       # # # #
# # # ####### ### # ##### ##### ### # ### ### ### # # ### ####### # ########### #
# # #       #   # #     #     #   # #   #   #   # # #   #       # #           # #
# # ############# # ######### ######### ### # # # # ### ### # # ### ### # # # # #
# #             # #         #         #   # # # # #   #   # # #   #   # # # # # #
# ### ##### # ### ####### ##### ##### ######### ##### ### # ### # # # ####### ###
#   #     # #   #       #     #     #         #     #   # #   # # # #       #   #
# ##### # ####### ##### ####### ### # ### ######### ##### # ### ### ### # ### # #
#     # #       #     #       #   # #   #         #     # #   #   #   # #   # # #
# # # ### # # # ### ### # # ##### ##### ######### ####### ### # # # ##### ### # #
# # #   # # # #   #   # # #     #     #         #       #   # # # #     #   # # #
# # # ######### ##### # # ####### # ### ##### ### ### # # # # # ### ##### ### ###
# # #         #     # # #       # #   #     #   #   # # # # # #   #     #   #   #
# # ##### # ### # # ### ##### ##### # # # ##### # ####### ### ### ### ### # # # #
# #     # #   # # #   #     #     # # # #     # #       #   #   #   #   # # # # #
# ### ### ##### # # # # ### ### # # # # # # ####### # # ### # # ### ##### ### ###
#   #   #     # # # # #   #   # # # # # # #       # # #   # # #   #     #   #   #
# ### ### # # ##### # ##### ### # ############# # ### ### ####### ####### ##### #
#   #   # # #     # #     #   # #             # #   #   #       #       #     # #
# ### # ##### # ### # ####### # ######### # # # # # # ### ######### ### ### #####
#   # #     # #   # #       # #         # # # # # # #   #         #   #   #     #
# # ##### # # ### ##### # ### ### # ### ### # # # ####### # ### ####### ### # ###
# #     # # #   #     # #   #   # #   #   # # # #       # #   #       #   # #   #
# # ##### # ##### # # ####### # ######### # ################# # ##### # # # # # #
# #     # #     # # #       # #         # #                 # #     # # # # # # #
# ####### # # ####### ##### ### ### # # ### # ### ### # # ##### # ### ##### # # #
#       # # #       #     #   #   # # #   # #   #   # # #     # #   #     # # # #
# # ### ##### # # ######### # # # ########### # ### # ### ### ### # ########### #
# #   #     # # #         # # # #           # #   # #   #   #   # #           # #
# # ### # # # ### ############# ### # # ############# # # ##### ### ##### ### ###
# #   # # # #   #             #   # # #             # # #     #   #     #   #   #
########################################################### #####################

