##################################################### ###########################
#                                                                               #
# ##### # ######### # ####### # # ######### ####### # ### # ####### ### ### # ###
#     # #         # #       # # #         #       # #   # #       #   #   # #   #
# # ##### # ### # ### ### ### # # # # ##### ############# ### # ### # # ####### #
# #     # #   # #   #   #   # # # # #     #             #   # #   # # #       # #
# # # ### ### # ##### ##### ##### # ### ### ##### # # ### # # ############### # #
# # #   #   # #     #     #     # #   #   #     # # #   # # #               # # #
# # ##### # ### ##### # # ### # ######### ##### ####### ##### ### ### ##### # ###
# #     # #   #     # # #   # #         #     #       #     #   #   #     # #   #
# ### # # # ### # # # ### ### # ### # # ##### ### ######### # ### ##### ####### #
#   # # # #   # # # #   #   # #   # # #     #   #         # #   #     #       # #
# # # # # ######### # # ### ######### # ### # ##### ### ### # ### # ####### # ###
# # # # #         # # #   #         # #   # #     #   #   # #   # #       # #   #
# ### # ### ### # # ##### ####### ##### ##### # # # # # ### # ### # ### # # ### #
#   # #   #   # # #     #       #     #     # # # # # #   # #   # #   # # #   # #
# ##### # # ####### ### # # # ##### ### ####### ### ### # ######### # # # # #####
#     # # #       #   # # # #     #   #       #   #   # #         # # # # #     #
# ########### ######### # # # ### ### ### ### ##### # # ### # ##### # # # # # # #
#           #         # # # #   #   #   #   #     # # #   # #     # # # # # # # #
# # # # ### # # # # ####### # ### # ####### ##### ### ##### # # # ####### ##### #
# # # #   # # # # #       # #   # #       #     #   #     # # # #       #     # #
# # # ### # # ### ### ####### # # ### # ### # # # ##### # ### # # ### ######### #
# # #   # # #   #   #       # # #   # #   # # # #     # #   # # #   #         # #
# # # # ####### ##### ####### ### ### # # # ### ####### ####### ### # # # # ### #
# # # #       #     #       #   #   # # # #   #       #       #   # # # # #   # #
# ##### # # ##### ####### # ######### # # ### ### # # # # ### # ### # # #########
#     # # #     #       # #         # # #   #   # # # # #   # #   # # #         #
# # ### # # # # # # # # ### ### # # # ##### ### ### ########### # ############# #
# #   # # # # # # # # #   #   # # # #     #   #   #           # #             # #
# ##### # # ### ### # ######### ####### ### # ### ##### # ####### ##### # # # # #
#     # # #   #   # #         #       #   # #   #     # #       #     # # # # # #
# # ### # # # # ### # # ##### ### # ##### # # # ##### # # ##### # ### # ### # # #
# #   # # # # #   # # #     #   # #     # # # #     # # #     # #   # #   # # # #
# # # ### ##### ### ### # # ### ### ##### ### # ####### # ### ### ##### # #######
# # #   #     #   #   # # #   #   #     #   # #       # #   #   #     # #       #
# # ### ### # ### # # # ##### # ### ########### # # ##### # # # ####### # # ### #
# #   #   # #   # # # #     # #   #           # # #     # # # #       # # #   # #
# # ##### # ### ####### ##### # ######### # ### ### # ######### ### # # # ##### #
# #     # #   #       #     # #         # #   #   # #         #   # # # #     # #
# # ### ##### ### ### # # # # ##### ########### # # # ####### # ####### # ### ###
# #   #     #   #   # # # # #     #           # # # #       # #       # #   #   #
# ##### ##### # ############# ### ### # ######### # ##### # # # ####### # #######
#     #     # #             #   #   # #         # #     # # # #       # #       #
# # # # # # ####################### ########### ### ####### ### ### # # ### ### #
# # # # # #                       #           #   #       #   #   # # #   #   # #
# ########### # ##### # # # ##### # ##### # # # ####### ### # ### # # # # # #####
#           # #     # # # #     # #     # # # #       #   # #   # # # # # #     #
# # # ############### # # ############# ######### # ### # ### ### ########### ###
# # #               # # #             #         # #   # #   #   #           #   #
# ############### ######### ### # ### # ### ##### # ### # ##### # # # # # # # ###
#               #         #   # #   # #   #     # #   # #     # # # # # # # #   #
# # ####### ### ####### # ##### ##### ### ### ### # # ### ### # # ######### # # #
# #       #   #       # #     #     #   #   #   # # #   #   # # #         # # # #
# # # # # ##### ### ##### ### ### ##### # # ##### ##### ### # # # ##### ### ### #
# # # # #     #   #     #   #   #     # # #     #     #   # # # #     #   #   # #
################################################################# ###############

