##################################################################### ###########
#                                                                               #
# # # ####### ####### # # ##### ####### # ### ##### ##### # ####### ####### # ###
# # #       #       # # #     #       # #   #     #     # #       #       # #   #
# # # # # # ####### ##### # ######### ####### # # ### # # # # # # # ##### # ### #
# # # # # #       #     # #         #       # # #   # # # # # # # #     # #   # #
# ### ### ######### # # ### ##### ############### ### # ### # # # ######### #####
#   #   #         # # #   #     #               #   # #   # # # #         #     #
# ### ### # ### # # # # # ####### ### ### ### ### # # ######### # # ### ### ### #
#   #   # #   # # # # # #       #   #   #   #   # # #         # # #   #   #   # #
# ####### ### # ### # # # # ### # ######### ### ### ### # # # # ####### # # ### #
#       #   # #   # # # # #   # #         #   #   #   # # # # #       # # #   # #
# # # ############# ### # # ### # ########### # # ##### ### ### # ##### # ### # #
# # #             #   # # #   # #           # # #     #   #   # #     # #   # # #
# # ####### # # # # ####### ### ### # ### ### # # ##### ### # # # ####### # #####
# #       # # # # #       #   #   # #   #   # # #     #   # # # #       # #     #
# ### ##### # ##### # ##################### # # ### # # ##### ### # ### ####### #
#   #     # #     # #                     # # #   # # #     #   # #   #       # #
# ### # ##### ##### # ### # ########### ##### # ########### ##### ### # ### # # #
#   # #     #     # #   # #           #     # #           #     #   # #   # # # #
# # # ############# # # # ####### # # # ### # ####### ### # # ### # ######### ###
# # #             # # # #       # # # #   # #       #   # # #   # #         #   #
# # # ####### # # # ##### # ### ### # ####### # ######### ####### # ########### #
# # #       # # # #     # #   #   # #       # #         #       # #           # #
# # # # ### # ########### # ##### ####### ### # ### ##### # ### # ### ##### # # #
# # # #   # #           # #     #       #   # #   #     # #   # #   #     # # # #
# # ##### # ### ####### # # # ##### # ############# ########### ### ### # # #####
# #     # #   #       # # # #     # #             #           #   #   # # #     #
# ##### # # ### # # ### # ### ### # # # # # # ### ##### ### ######### ### ##### #
#     # # #   # # #   # #   #   # # # # # # #   #     #   #         #   #     # #
# ### ### ### ######### # # # # ### # ### ##### ####### ##### # ### # ####### ###
#   #   #   #         # # # # #   # #   #     #       #     # #   # #       #   #
# # ##### ##### ### # # # # ### ##### ####### ### # # # ### ### # ####### ### # #
# #     #     #   # # # # #   #     #       #   # # # #   #   # #       #   # # #
# ### ##### ### ### # ####### # ### ##### ##### # # # # ### # # ### ### # # ### #
#   #     #   #   # #       # #   #     #     # # # # #   # # #   #   # # #   # #
# ### # # ### ### ####### # # ##### # ######### ### ### # # # # ### ### ### # # #
#   # # #   #   #       # # #     # #         #   #   # # # # #   #   #   # # # #
# ####### # ### # # ##### # ### ########### ### # ####### ### ### # # # ### #####
#       # #   # # #     # #   #           #   # #       #   #   # # # #   #     #
# ### # ################# # # ### ### ### # # ### # # ### ### # # # ### ### #####
#   # #                 # # #   #   #   # # #   # # #   #   # # # #   #   #     #
# ### ### ############# ### # # # # ##### ##### ##### ####### ### ### # # # ### #
#   #   #             #   # # # # #     #     #     #       #   #   # # # #   # #
# ############# # ######### ##### ##### ### # # ####### ### ### ### ### #########
#             # #         #     #     #   # # #       #   #   #   #   #         #
# # ######### # # # # # # # ##### ### # ### # # # # # # # # ### # ### ######### #
# #         # # # # # # # #     #   # #   # # # # # # # # #   # #   #         # #
# ### # # ### ### # ### ####### ##### # # # ####### ### # # ######### ### # #####
#   # # #   #   # #   #       #     # # # #       #   # # #         #   # #     #
# # ### ########### # # # # ############### ######### ##### ### ##### # #########
# #   #           # # # # #               #         #     #   #     # #         #
# # ### ### ##### ##### ##### ##### # # # ### # # ##### ##### ### ### # # ### # #
# #   #   #     #     #     #     # # # #   # # #     #     #   #   # # #   # # #
################# ###############################################################

