########################################### #####################################
#                                                                               #
# # ### # # ########### # # # ### # # # ##### # # # ### # ##### ##### ### # # # #
# #   # # #           # # # #   # # # #     # # # #   # #     #     #   # # # # #
# # # # ##### # # # # ### ##### # # ### # ##### ### # ### # ######### # ### # # #
# # # #     # # # # #   #     # # #   # #     #   # #   # #         # #   # # # #
# # # # # ### # ### # # # ########### # ####### ######### # ##### ### ### # # # #
# # # # #   # #   # # # #           # #       #         # #     #   #   # # # # #
# # # # # # # # # # # # # ##### # ##### ##### # # ################# # ####### # #
# # # # # # # # # # # # #     # #     #     # # #                 # #       # # #
# ######### # # ### # ##### ######### # # # # # # ##### ##### ############# # # #
#         # # #   # #     #         # # # # # # #     #     #             # # # #
# ### ### # ### # # # # ### # ### ### ##### ### # # # # # # ##### ##### ### # ###
#   #   # #   # # # # #   # #   #   #     #   # # # # # # #     #     #   # #   #
# # ############# # # # # # # # ### ### ### # # # # # ### # ### # ### ### ### ###
# #             # # # # # # # #   #   #   # # # # # #   # #   # #   #   #   #   #
# # ########### ### ### # # # # ### # ##### # ### ##### # ### # ### # # # # # ###
# #           #   #   # # # # #   # #     # #   #     # #   # #   # # # # # #   #
# ### # ### ####### ### ##### ### # ### # # ####### # ##### ### # ######### ### #
#   # #   #       #   #     #   # #   # # #       # #     #   # #         #   # #
# ####### ### # ### # ##### ######### ############# # ##### # ##### # # # # #####
#       #   # #   # #     #         #             # #     # #     # # # # #     #
# ### # # # # ######### # ######### # ### # ##### # # ### ### # # # ### ##### # #
#   # # # # #         # #         # #   # #     # # #   #   # # # #   #     # # #
# # # ### ##### ### ##### # ### ### # # # # ######### # ##### # # ####### ##### #
# # #   #     #   #     # #   #   # # # # #         # #     # # #       #     # #
# # # ##### # ####### ##### # ### # ### ######### ### ####### ####### ##### #####
# # #     # #       #     # #   # #   #         #   #       #       #     #     #
# # ####### # # ##### ########### ### ### ### ########### # ##### ##### ### ### #
# #       # # #     #           #   #   #   #           # #     #     #   #   # #
# # ############### # ### ##### # ####### ### # ########### # # ##### ### # ### #
# #               # #   #     # #       #   # #           # # #     #   # #   # #
# # ##### # # ####### # # # ####### ### # # ### # # # ### ##### # # ### ####### #
# #     # # #       # # # #       #   # # #   # # # #   #     # # #   #       # #
# # ### # # # # ####### # # # ############# # # # # ######### # # # # ####### # #
# #   # # # # #       # # # #             # # # # #         # # # # #       # # #
# # # # ### ### ### ##### ######### # # # # ##### ### # # # ##### # ##### ### # #
# # # #   #   #   #     #         # # # # #     #   # # # #     # #     #   # # #
# ### ### ##### ### # ### ### # # ### ##### ### ####### # # # ### # # ####### ###
#   #   #     #   # #   #   # # #   #     #   #       # # # #   # # #       #   #
# # ### ### ### # # ### # # ##### # ############# ##### ##### # # # # # # ### ###
# #   #   #   # # #   # # #     # #             #     #     # # # # # # #   #   #
# # ### # # ### ### # # ##### ### ####### # ### # # ##### ######### ### # #######
# #   # # #   #   # # #     #   #       # #   # # #     #         #   # #       #
# # ##### # # ####### ### # # # ### # # # # ### # # # # # ##### ### # ### # ### #
# #     # # #       #   # # # #   # # # # #   # # # # # #     #   # #   # #   # #
# # ### ####### ####### ### ### ### ### ##### # # # ##### # # ### ### ####### ###
# #   #       #       #   #   #   #   #     # # # #     # # #   #   #       #   #
# # # # # # # # ######### ### # ### ### ##### # # # # # # # # ### ### ### ### ###
# # # # # # # #         #   # #   #   #     # # # # # # # # #   #   #   #   #   #
# ##### # # ####### ### ### # # ####### ### # # # # ####### # ### # ### ### #####
#     # # #       #   #   # # #       #   # # # # #       # #   # #   #   #     #
# # # # # ####### ##### ############# # # ####### # # ### ### ### # # # ### # # #
# # # # #       #     #             # # #       # # #   #   #   # # # #   # # # #
# ### ##### ####### ### # ### ######### # # ############# # ### ### # ####### ###
#   #     #       #   # #   #         # # #             # #   #   # #       #   #
################################################################# ###############

