################################### #############################################
#                                                                               #
# # ### # # ############# ##### # # # ##### ######### # # ##### # ##### ##### # #
# #   # # #             #     # # # #     #         # # #     # #     #     # # #
# # # ### ############# # # ### ### ####### ### # # ########### ######### # #####
# # #   #             # # #   #   #       #   # # #           #         # #     #
# # # ##### ### ### # # ### # # # # # # ##### # # ########### # ### # # # # ### #
# # #     #   #   # # #   # # # # # # #     # # #           # #   # # # # #   # #
# # # ### ### ############# ##### ####### ### # ##### ### # # ### ### # # # ### #
# # #   #   #             #     #       #   # #     #   # # #   #   # # # #   # #
# # ### ### ##### ######### # ### ### # ### ##### # # ### # ### # # # ##### ### #
# #   #   #     #         # #   #   # #   #     # # #   # #   # # # #     #   # #
# # # ##### # # ### # ### # # ##### ####### # ### ####### ##### ######### #######
# # #     # # #   # #   # # #     #       # #   #       #     #         #       #
# ### ####### ####### ####### # ### # # ### ### # # # ### ### # # ##### # # ### #
#   #       #       #       # #   # # #   #   # # # #   #   # # #     # # #   # #
# ### ### # ####### # ####### ### # # ### # # ### # ### # # ### ##### ##### # ###
#   #   # #       # #       #   # # #   # # #   # #   # # #   #     #     # #   #
# ### ####### # ##### # # # ### # # ### # ####### ### ### ##### # # ##### ### # #
#   #       # #     # # # #   # # #   # #       #   #   #     # # #     #   # # #
# ##### ######### # # ##### ### ##### # ### ##### ##### ### # # ########### # # #
#     #         # # #     #   #     # #   #     #     #   # # #           # # # #
# ### # # ### # ####### ### # # ##### ######### # ######### ### ####### ##### # #
#   # # #   # #       #   # # #     #         # #         #   #       #     # # #
# ##### ####### # ### # # ############# ######### ### ### ### ### # ### # ##### #
#     #       # #   # # #             #         #   #   #   #   # #   # #     # #
# ### # ##### # ### # # # # # ### ####### ### ### ##### # # # ### # ### # # ### #
#   # #     # #   # # # # # #   #       #   #   #     # # # #   # #   # # #   # #
# ### # ### # # # ##### ### ##### ####### ### # # # # # ##### ### ### # ### ### #
#   # #   # # # #     #   #     #       #   # # # # # #     #   #   # #   #   # #
# # # # ### ####### # ####### ### # # ##### ### # ##### ##### # ### ### # ### ###
# # # #   #       # #       #   # # #     #   # #     #     # #   #   # #   #   #
# ####### # ### # ####### # # # # # # ### ### ### # ### ### ### ##### ### # #####
#       # #   # #       # # # # # # #   #   #   # #   #   #   #     #   # #     #
# # # ####### # # ### # # # ### # ######### # ### ### # # # # ####### ###########
# # #       # # #   # # # #   # #         # #   #   # # # # #       #           #
# ### # # ##### # ### ### # ### # ##### ### # # # ### # # # # # # # # ##### ### #
#   # # #     # #   #   # #   # #     #   # # # #   # # # # # # # # #     #   # #
# # # ####### ######### ##### # # ##### ################### ##### ##### # # #####
# # #       #         #     # # #     #                   #     #     # # #     #
# ############# ######### ########### # # ### ##### # ### # # # ##### ### # ### #
#             #         #           # # #   #     # #   # # # #     #   # #   # #
# # ####### ##### # # ### # # # # ##### ########### # ### ##### # # # ##### #####
# #       #     # # #   # # # # #     #           # #   #     # # # #     #     #
# # # ### ########### # # ### ### # # # # # ### ### ### ### # ### ############# #
# # #   #           # # #   #   # # # # # #   #   #   #   # #   #             # #
# ##### # ########### # ### # # ### # ##### ##### # ##### # # ##### ####### ### #
#     # #           # #   # # #   # #     #     # #     # # #     #       #   # #
# # # # # # ### ### # ### # # ####### ### # # ##### # # ### # # # # # # ##### # #
# # # # # #   #   # #   # # #       #   # # #     # # #   # # # # # # #     # # #
# # # # # ### # # # # # ##### ##### ### ####### ##### # # ### ##### # ### #######
# # # # #   # # # # # #     #     #   #       #     # # #   #     # #   #       #
# # ##### ##### # ### # ##### # ####### ### ### # ####### ### # ### ##### # # # #
# #     #     # #   # #     # #       #   #   # #       #   # #   #     # # # # #
# ##### ####### ### ##### # ### # ####### # ####### ##### # # ####### # #########
#     #       #   #     # #   # #       # #       #     # # #       # #         #
####################################################################### #########

