### #############################################################################
#   #               #   #   #             #         # # # #       #             #
### ##### ####### # ### ### # # ######### ##### # ### # # ### ##### ### ### #####
#   #   # # #     # #   #   # # #   #           #     #   # #     # # # #   #   #
# # ### ### ##### ### # # ### ### ######### ####### ### ### # ##### # ### # ### #
# #   # # # #         # # #   #     # #       #         #   # #     #   # #   # #
# # # # # # ### ####### # # ##### ### ### ### # # # ### # ### # ### # ######### #
# # #     #         #       #   #     #     # # # #   # # #   # # #   #         #
##### ### # ### # ##### ##### ####### # ####### ####### # ### ### # # ##### # ###
# #   #     # # #     # #   #     #     #   #   #     #   # # # #   #   #   #   #
# # # ### # # ######### # ##### ##### ### ##### ##### ### # # # ### ### ### ### #
#   # #   # # #       # #   # #     # #     #   # #           #       #       # #
# ########### # ### ##### ### ### # ####### # # # ##### ### # # #################
# #     #       # #   #           # #         # #       #   #   #   #   # #     #
##### # # ### # # ### ######### # # # ######### # ### # ### # # ### ### # ### ###
#   # #     # # #   #   # #     # #   # #     # #   # # #   # #       # # # #   #
# ####### # ##### # # # # ### ####### # # # # # ### ##### ####### # # # # # # # #
#   #     #     # #   #   #         #     # # #   #     # # #     # #     #   # #
### ##### ############### # ### # # ##### # ##### ######### # ######### # ### # #
#       # #     #           #   # # #     #   # #   #         #       # #   # # #
####### # ##### ### # ### ##### # ####### # # # # # # # ##### # # ### ### # # # #
#         #         # #       # #     #   # # #   # # #   #     #   # #   # # # #
# # ####### ##### ##################### # # ### ### ### ####### ####### ##### # #
# #   #     #             #       #   # # # # #   #   # # # #     # #     #   # #
# # ######### ######### ### ##### # # # ### # ##### ##### # ### ### ### ### #####
# # #   # # #     #   #   #     # # #   # #   #     #         # # #         # # #
### ### # # ### # # ########### # ##### # ### # # # ### ##### ### # # # ##### # #
#     # #       #     #       # #     # #     # # # #     #       # # #     #   #
# ##### # # ##### ### ### ####### ### # ### ####### # # ################# ### ###
#   #     # # # # #         #   #   #   # # #   # # # # #   #     # # #     # # #
### ##### ### # ##### ######### # ##### # # # ### # ### ### ### # # # ### # # # #
#   #   # #   # #         #   # #   #     #   #     #       #   # #   #   #     #
# # # # ##### # # # ### # # # # ##### ##### # ######### # ### # # ### # # ##### #
# # # #         # # # # # # #       # #     #         # # #   # #       # #     #
# ##### # ### ####### # ### # ### ############### ##### ### # ######### # ##### #
#   #   # #   #         # # #   # # # # #   #         #   # # #     # # #   #   #
####### ##### # # ### # # # # # ### # # # ##### # # # ### ####### ### # ##### # #
#   #     #   # #   # # #   # # #   #     #   # # # # #   #           # #   # # #
# # # ### ### ######### # ### ### ####### # ############# ### ### # ### ### #####
# # #   #   #       # # #   # #     #   # #   #             #   # # #   #   #   #
# ############# ##### # # ######### ### # # # # # ### ### # # ######### # ##### #
#         # # #   # # # # # #   # # #   #   # # #   # # # # # #   #       #     #
# ##### # # # ### # # # # # ### # # ### ### ### # ##### ### # # ####### # ##### #
#   #   #         # # # # #   #         # #   # # #   # #         # #   #   #   #
# ### ########### # # # # # ### # ##### # # # ##### # # # ####### # ### ####### #
#   # #     #     #   # # # #   # #         # #     # #   #     #   #     #   # #
# # # # ### ##### ### # # # ### ##### ############# ### ### ### # ##### ### ### #
# # # # #   # #           # #       #   # #   # #         #   # #           # # #
### ##### # # # ########### ####### # # # # ### ### # ### # ### ### ######### # #
# # # #   # #     #     # # # #     # #   #     # # #   # #   #       #     #   #
# # # # ### ### ####### # # # # ############### # # # ### # # ### ######### # # #
#   #     #   # #   #   # # #     #   #   # # #     #   # # # # #   #   # #   # #
######### ##### ### # ### # # # ### # # ### # ##### # # ####### # # ### # # #####
# #   #                       # #   #           #   # # # # #   # #             #
# # ### ##### ### ### ### ##### # # ### # ### # # ### # # # ### # # # ##### ### #
#           # #     #   #     # # #   # #   # #   #   # #         # #     #   # #
################### #############################################################

