######################################################### #######################
#                             #   #         # #   # #       #   #         #     #
####### # ############# # # # ### # # ####### ### # ### # # ### ######### # ### #
#   # # #       #   #   # # #       # #         #       # #         #       # # #
# # # # ########### ### ##### ####### # ####### ### ### ### ##### ### # ##### # #
# # #         #     #   # #   # # #         #         # #   #       # # # #     #
### # ### # # # # ####### # ### # ### # # ### ### ### ##### ##### ### # # # ### #
# # # # # # # # # # #       #         # #   # #   #     # #     #     # #     # #
# # ### # ### ### # ##### ### # # # ####### # # ### ##### # # ### # ##### ### # #
# # #   # # # #         # # # # # #   #     # #   #       # #   # #   # #   # # #
# # # ##### # # ########### ######### ##### ### ####### # ####### ##### ####### #
#       #   #     #     #         #   #       #   #     # # #                 # #
### ####### ### ### ### ####### # ##### ####### ######### # ### ####### # # # # #
#   # #         # # #     #     #   # # #   # #     #     #   # # #   # # # # # #
### # # ##### ### ####### # # # # ### # # # # ### ### ### # ##### # ### ### ### #
# #     # #   # #   # #     # # # # #   # #   #   #   # #     # #   # # #     # #
# ### ### # ### ### # # # ### ##### ### # # # ##### ### ### # # ### # ######### #
#         #       #   # # #   #   # #     # #   # #     # # # #     #       #   #
# # # # # ####### # # ### ##### # # # ##### ### # ### ### ####### # # ####### ###
# # # # # # # # #   # #         #         # #     # # #   #     # # #     #     #
# ######### # # # ### ####### # ### ####### # ### # ### ####### # # # ##### ### #
#   #       # #     #       # # #     #     #   #   #     #       #     #   # # #
### # ##### # # # ### # ####### ##### ##### ##### # # # # ### ##### ### ### # # #
#   # # #       # #   #   #         #   #   #   # # # # #     #     #         # #
# # ### # # ### # ####### ### # # ### ####### ### ### # # ### # ##### # ### ### #
# # #     #   # # #       # # # #   #   #   # #     # # # # # #   # # #   # # # #
# # ##### ####### ####### # ### ##### # ### # ##### # ### # # ##### ######### ###
# # # #     # #   # #       # #     # #   #         #   #   # #   # #     #     #
# ### ##### # ##### ### # # # ##### # ####### # ### ##### # ##### # ##### ### ###
# #   #         #   # # # #   # # # #   #   # # # #     # #     #   #     #   # #
# ### # ########### # # # ### # # # # # ### ##### # ######### ##### # # # # # # #
#   #         #         # #   # # # # # #   #           #   # # #   # # # # #   #
# # ########### ##### ### ### # # # # # # # ##### ######### ### ### ##### ### # #
# #       #         #   # # # #   # # # # #   # # #   # #   # #               # #
# # ####### ##### ####### # ### ### # # # ##### # ### # # ### # ########### #####
# # # #   # # #       #   #         # # #     #     #         #     #           #
# ### # ##### # # ####################### # # # ############# # # ### ### ### ###
# #     # # # # #     # #               # # #             #   # #   # #   # # # #
# # # ### # # ### ##### # ### ####### ######### # ### ### ### ############# # # #
# # #   # #                 #   #         #     # #   #           #     #       #
##### ### # # ##### # ##### ### ### ### # # # ### ######### ##### ### # # ### ###
#       #   #     # # #     #   #   # # # # #   # #     #   #         #     #   #
### ### # # # # # ### # # ### # ##### ######### # # # ### ### ### ### ##### ### #
#   # # # # # # # # # # #   # #       #   # #   # # #     #   #   # # # #     # #
# # # ####### # # # ########### # # ### # # # ##### # ##### # # # # ### # ### # #
# # #         # #     # #   #   # #   # #   #   # # # #     # # #   #     #   # #
# ### ### ##### ####### ### ### # ### # ######### ### # ##### ##### ### # ### ###
#   # #       #   #     # #   # # #     #     #       # #   # #       # # # #   #
### ### ############### # ### # # # ### ##### ######### # ############# ### # ###
#             #       # # #   # # #   #               #         #         #     #
# # # ### # # # ####### # # ####### ##### ####### ######### ### ######### ### ###
# # # #   # # #   #           #         # #     #     #     #     #   #   #   # #
### ### ### # # # # # # ####### ##### ### ### # # ### ### ########### # ### ### #
#     #   # #   #   # #   #         # #       # # #   #         #         #     #
########################################### #####################################

