# ###############################################################################
#   #     # #   #         #   #   # #   # #           # # # #   #             # #
# # ### ### # # ######### ### ### # ### # ######### # # # # ### # ### ##### # # #
# #         # # # #     # #     # #   #         # # #   #   #     #   #     #   #
# # # ######### # ##### # ##### # # ### # ####### ### # ### # ##### ####### ### #
# # #   #       #         #     #   #   # #       # # #       #   #   # #     # #
# ### ##### ### # ####### ##### ### ### ######### # ########### ####### # #######
# # #   #     # #       #   # #   #           # #       #   # #             #   #
# # ### ##### ######### ### # ### ##### ##### # ### # ### # # ### ######### ### #
# #   #   # # #     #   #           #     # #   #   # #   #         #   # #     #
# ### # ### # # ### ### # ### ### ### ##### ### ##### # ### # ####### # # ### ###
#   #     #   # # # #   #   #   #       # #         #     # #   #     #   # #   #
# # # ##### ### # ######### # ####### ### # ########### # # ########### # # # ###
# # # # # # # #   # # #   # #   #       #   # # #   # # # #     #       #       #
# ### # # # # # # # # # # # ######### ####### # # ### ##### # ######### # # ### #
# # #       #   #     # # #   #       # # #   # #   # #     #         # # # #   #
# # ### ### ####### ### # ####### ##### # ### # # # # # # ##### ### ### ##### # #
# # # #   #   #         # # # # # #               #   # #     # #     #   #   # #
# # # ### ####### ### ##### # # # # ####### ############# # # ####### ##### ### #
# #             # #   #   #     # #   #     # #           # # #   #   #   # # # #
##### ### # # # ### ### ### ##### # ##### ### ##### # # # # ### ####### ##### # #
#   #   # # # #   # #     #     # # #   # # #   #   # # # #   # #   # # #     # #
# ######### ### # # ### # ##### # # # ##### ### ### ### ##### # # ### # ### #####
#             # #     # # # #     #   # # # #   # #   #     # #                 #
# # # ### ##### ### # ### # ##### ### # # # ### # ### ############### ######### #
# # # #     #   #   #     #                           # # # # # # #   #   #   # #
### # # # # ### ### ### ### ### ##### ########### # ### # # # # # ### # # # # # #
# # # # # #   # #   #   #     #     # #       # # # #   # # #       #   #   # # #
# ### # ### # ### # ##### ####### ######### ### ### # ### # # ##### # # # #######
#   # #   # # #   # # #     #       # #       #       #       #       # #   #   #
### ####### ### ##### ##### # ##### # ### ####### # ########### ### ##### # ### #
#     # # #   #     # #   # # # #   # #   # #     # # #       # # # #     #     #
# # # # # # ### ##### # ####### ### # # ### ######### # ######### # ##### ##### #
# # #   # # # #       # # #   #                 # #                 #         # #
### ### # ### ####### # # ### ### ### # ##### ### ####### # # # # # # ##### # ###
# # #   #   # # #         #         # #   #         #   # # # # # # # #     #   #
# ### ##### # # ### ### ####### ### # ####### # ##### ##### # # ### ### #########
#         #   # # # #           #   #     # # #         #   # #   # #           #
# ##### ##### # # # ##### # ######### ##### ### # # ##### ### # ####### # ### ###
#   #   # # #   # #     # #       # #   # #   # # #         # # #       # #     #
##### # # # # ### ### ####### # ### ### # # # # ################# # ### ### ### #
#   # # #   #               # # #           # #     #           # #   # #     # #
# # ### ### # # ### ##### ######### # ### # # ### # # # # ########### ### ### ###
# # # # #     #   #   # # #   #     #   # # # # # #   # #   #   #     # # #     #
### # # ### ######### # ##### # # # # ##### # # ### # ##### ### ### # # ### #####
#       #     # # #     #     # # # #   #   # #     #     #       # #     # #   #
### ##### ##### # ####### # ####### ####### ### ### # # # # ######### ### ### ###
#     #   #   #   #       #   # #     #     # # #   # # # #     # #   # #       #
##### # # # ### # # ##### ##### # ####### ### ##### ######### ### ### # ### # # #
#     # #       #     #   #       #       # #   #       #   #   #     #   # # # #
# ##### # # ### ### ##### ### ### ### ##### # ### ##### # ### # ### ##### ### ###
#   # # # #   # #   #       # #   #     #   #   # #   #     # # #   #   #       #
### # ############# ### ### ##### ### # # ### # ##### ##### # ### ##### ####### #
#     #             #   #   # #     # #       #   # #       #   #     #         #
### ### # # # # ##### # # ### # # # ##### ### ### # ######### ####### # ####### #
#       # # # # #     # #     # # #   #     # #             #       # #   #     #
########################################### #####################################

