####################### #########################################################
#                 #   #       #     # # #             #   #         # #     # # #
### # # ######### # ##### ### ##### # # ##### # # # # ### # ##### ### ##### # # #
# # # # #         #     # #     # # # #   # # # # # # #     #   # # # #     # # #
# ########### ### ##### ##### # # # # # ### ##### ##### ### # ##### # ### ### # #
#     #   # # #         #     #   #         # #   # # # # # # #   #   #         #
# ### # # # # # ############# ### ##### ##### ### # # # # ### # ##### # ### # # #
#   #   #   # #         #   # #             # #       # # #   #     # #   # # # #
# # # ### # ##### # ##### ####### ######### # ##### ### # ### # ### # # #########
# # # #   # #   # #   # #   #     #   # #         # # # # #   # # # #           #
# ######### ### # ##### ### ######### # ### ### ### # # # # ##### # # ##### #####
#   # # #             #                   # # #   #     # # # # # # #     #     #
##### # # # ### ########### ####### # # ##### # ### ### # # # # # # # # ####### #
# # #     # #     #   # #   #   #   # # #   # #       #               #     #   #
# # ### ##### ####### # # ### ########### ### # ### ####### ####### ##### # # # #
#     # #   # # # #   #   #         #   #     # #   #     #       #   # # # # # #
# ### # # ### # # ### # ########### ### ##### ### ####### ############# ##### ###
# #       #             # # # #   # #   #     # #   #           #         # #   #
# ### ############# ##### # # # ### ### ##### # ### ##### ### # # # ##### # # ###
# #   #   # #     #     #     #     #     # #           #   # #   # # # # #   # #
### ### ### ### ### ######### # ### # ### # ####### ######### # ### # # # ### # #
#   # # # # # #   #         #     # # # # #     # # # #     # #   # # # #   #   #
### # # # # # # ##### ####### # # # # # # ##### # # # # ######### ### # #########
#   # #   # #                 # # # # # #     #           # #     # #   # #     #
##### # # # ### # # ##### ##### # ##### ##### ### ### ##### # # ### # ### ### ###
# #     #       # #   #     # # #   #   # #   # #   # # # # # #       #     #   #
# ##### ##### ##### ######### ######### # # # # # ### # # # # ############# ### #
#     # #     #   # # # #       # #   #   # #   # #     #   # # # # #     #     #
# ##### ##### ### ### # # ### # # # ### ##### # ##### # ### # # # # ##### ##### #
# #       #       # # # # # # # #     #     # #   #   # #                 #   # #
# # ######### ### # # # # # ####### ##### ##### ####### ########### # # ##### # #
#   # # # # # #     #     # # # #         #   # # # # #     #   #   # #         #
##### # # # # ##### # # # # # # # ##### ### ### # # # # ##### # ### ####### # ###
#     #     #   #   # # # #   # #     #   #   #   #   #       #   #   #   # #   #
# # ####### # ##### ##### ### # ##### ####### ### # ##### # ### ####### ##### ###
# # #       #     #   # #   #   # #   #         #         # #     # #   # # #   #
### # ### ### # # # # # ### ### # # ### ####### ### # # # # ##### # # ### # ### #
#   # #     # # # # # #                 #   #       # # # #     #     #   #     #
### ### # # # ####### # # # # ### # ### # ##### # ##### ### ### ####### # # ### #
# # #   # # # # #       # # #   # # #   #     # # # #   # # #   #       # #   # #
# # # # ####### # ######### ####### # ### ### # # # ### # ####### ##### # # # ###
#   # # #       #       #   #       #   #   #   #     # #   #       # # #   # # #
### # # # ##### # # # ##### ############# ##### ##### # # ########### ##### # # #
#     # #     # # # #     # #     #   #     # #   #   # # #   #     #     # #   #
# ### # # ########### # # ##### # ### ### # # # ####### # # ##### # # ##### #####
# #   # #   #     # # # # #   # # #       # #   #   #   # #     # #           # #
# ##### ### ### ### # ### # ##### # # ####### # ### ##### # # ##### ##### ### # #
# #   #   # # #       #       #     # # #   # #         #   # #         #   #   #
# ### ### # # ##### ####### ##### # ### ### ### ##### # # ### # ##### ##### # # #
# #         #         #   # #     # # # #     #     # #   # # #     # # # # # # #
# ######### ######### # ####### # ### # ### # ### # # # ### # # # # ### # # # ###
# # # #     #     #   #       # #     #     #   # # # #   #     # # # #   # #   #
# # # ### # ##### # ####### ### ######### # ##### # # # # # # ##### # # # # ### #
# #       #       #     #     # #         #   #   # # # # # #   # #     # #   # #
# ### ##### ##### # # # # # # # # # ##### ##### ####### ##### ### # ### # # # ###
# #       # #       # #   # # #   # #         # #           # #     #   # # #   #
######################################### #######################################

