################# ###############################################################
#   #     #               # #             #               # # # #           # # #
### ##### ##### ##### # ### ####### ##### # # ############# # # ##### ##### # # #
#   # # #     # #   # # #               #   # #     # # #         # # # #   #   #
# ### # # # # # # ### # ########### # ### ##### # # # # ####### ### # # # ##### #
#         # #       # # #           # #     #   # #   #   #     # # # #         #
# ########### ######### ####### # ### ### # ######### # ####### # # # # ### # ###
# #                 #   #       #   # # # #   #               # #     # #   #   #
# # ### ########### ##### # ### # # ### ### ### ### ### ####### ##### # # ### # #
# # # # #         #   # # # #   # # # #       #   #   #       #   #   # #   # # #
# ### ##### ### # ### # ### # ####### # ##### # # # # ### ##### # # ##### ### ###
# # # # #     # #   # #   # # #     #   #   # # # # #   # #     #   # #   #     #
# # # # ### ### ### # ### ### # # # # ##### # # ########### # ####### # ### # ###
# #       # # # #   # # # # # # # #   # # #       #   #     #     #       # #   #
### ######### ##### # # # # ########### # ####### ### # ##### ### ########### # #
#           # #     #     # #   #         #       #   # #   #   #       # # # # #
# ### ##### # # ##### ### # ### ### ##### # ##### # ### ### ####### # # # # ### #
# # #   # # #         # #   # # # #   #   # #   #   # # #   # # # # # # #   #   #
### # ### # ### ####### ##### # # ### ##### ### ### # ##### # # # # ##### # ### #
#   # #   # # #       # #   #     #         #     #           #     # #   #   # #
# ##### ### # ####### # ### # ######### ##### ##### ####### ### ### # # # # ### #
#       #     # # #     # #                       #   # # #   # # #   # # #   # #
# # ######### # # # ### # ##### # ######### # ##### ### # # ##### ### # ####### #
# #     #         #   #   #   # #     #   # # #       #             # #       # #
# # ########### ######### # # # # ### # ##### ##### ####### ####### # ### # #####
# #         # #             # # #   #   #     #     #       #     #       #     #
# ### ### ### ### ####### ### ### # ### ### # ##### ####### # # # ### ##### # ###
#   #   # #   # # #   #   #     # # #     # # #     #         # #   # #     # # #
######### # ### ##### # # ### # ##### ##### ### ### ##### # # ####### ####### # #
# # # #       # #     # #   # #   # #     #   # #       # # #   #     # #       #
# # # ####### # ##### # ### # ##### # ### ### ### # ############# ### # # ### # #
#     #   #   #           # # #         #   # #   # # #   #   #     # #   #   # #
# ##### ### # # # ### ######### # ####### ##### ##### ### # # ####### ###########
#         # # # #   #   #       # #     # #   #   # #       #       # # #       #
# # ### # # ##### # ######### ### ### # # # ### ### ### # ### ##### # # # # ### #
# # # # #         #   #   # #   #     # # #   # #     # #   # #           #   # #
##### ##### # ### ### ### # # # ### # # ##### ####### ### # ### # ##### # ##### #
#           #   # #       #   # #   # #     #     # # # # # # # # # #   #     # #
# ### # # # ### ##### ##### ######### ####### ### # # # ### # ### # # # # # # ###
# #   # # # # #     # #         #       # #   #   #     #   # # # #   # # # #   #
# # ### # # # ####### ### ####### # ##### # # ######### # ### # # ############# #
# #   # # #         #         #   # # # #   # #         #   #   #         #     #
# # # ##### ### ##### ### ##### # ### # # ######### ### # ### ####### # ### ### #
# # #   # #   # #   # #       # #   #         #   #   # #           # # #     # #
####### # ######### # ########### ### ### # ##### # ##### ############# # ### # #
#   # #     #   # #       # #       # #   # # #       #     # # #       # # # # #
### # ##### ### # ### ### # ### # # ####### # # ##### ##### # # ########### # # #
#   #   # #   #     #   # #   # # # # #           #   #     # #         #   # # #
### # ### ### # ### # ##### ### ##### ##### ##### ######### # ### ####### # ### #
# #               # #       #   # # # #     #     # #   #   #             #   # #
# ################### ########### # # ####### ### # # ##### ### # ### ##### ### #
#               #   #   # #                 # # # #   #         #   #   #     # #
# ### # ####### # ### # # # ####### # # # # ### # ### ### # # # ### ##### #######
#   # #       #       #           # # # # # #             # # #   # #           #
####### #########################################################################

