########################################### #####################################
#                 #                             #           #         #   #   # #
############# # # # # ### # # # # ####### # ########### ### ### # ### ### ### # #
#   # #   #   # # # # # # # # # # # # #   # #   #   #     #     # #     # # #   #
### # ### ### ### ##### ### ##### # # ######### # # # # ### ######### ### # ### #
#     # # #     #     #     # #   # #   #   #     # # #   # #   #   #   #       #
# # # # # ##### # # ######### # ### # ##### # ############### ##### # ##### ### #
# # # #   #   # # # #     # # # #       #   #             # #   #     #       # #
# # ##### # ### ##### # # # # # # # ##### ##### ##### # # # # # # ##### # #######
# # #   #   # # #   # # #   #     #     #           # # # # # # #     # # #     #
### # # # # # # # ### ##### # ### ######### # # ### ##### # # # # # # # ### # # #
#     #   #   #       #     #   #     # #   # #   # #         #   # #       # # #
# # # ### ### # ########### # ##### # # ### ####### ##### # # # # ###############
# # # #   #             #         # # # #   # #         # # # # #     #         #
# ### # # # # # ### # ### ### ######### ### # # ### # # ##### # ##### ### ##### #
# # # # # # # #   # #   #   #   #           #   # # # #     # # #       # #     #
# # ### # ####### # ##### ##### ############# # # # ########### ### ### ####### #
#     # #   # #   # # # #   #   #   #       # # # # #     #   #   # # # #     # #
# ####### ### # # # # # # ### # # ####### ### ### # ##### ### # ##### # # ##### #
#     #   # # # # # # #   # # #                   #   #     # # #           # # #
# ### # # # # ##### # ### # # ### # ####### ####### # # ##### # ####### ##### # #
#   # # # #     #   #       # #   #   #   #     # # #     #   # #   #     #     #
# ######### ##### ####### ############### # ### # ### # ### # ##### ### ### #####
# #       #     # #   # #     # #         #   # #   # #   # # # #   # #   #     #
### ##### # ####### ### # ##### # # ########### ### ##### # ### ### # # ####### #
#     #     #   #   #   # #       #             #   #         #   #         #   #
### ##### ### ### # # ### ####### ### ####### ##### # ####### ### ####### # # # #
#       #         #     #   # #     #   #           # # #           #     # # # #
# # ##### ########### ##### # # # # # # # ####### ##### ####### ######### ### # #
# # # #     # # #     # #   #   # # # # # # #   #       #     #   #       #   # #
# ### # ##### # ##### # ##### # # ####### # # ### ########### ######### ### # ###
# # #     #   #   #   #       # #   #       #   # #   #   #   # # #       # # # #
### ####### ### ##### ##### ### # ### ### ##### ### ##### ### # # ##### # ### # #
#   #                         # # #   # # #       # #   #     # #   #   # # # # #
### ####### ##### ######### # # # ### # # # ##### # ### # ##### ### # # ### # # #
#     #     # # # #   #     # # #   #   # # # # #   #   #     # #   # #   #   # #
# ### ### ### # ### # # # ####### ##### ##### # # # # # ##### # # ### ##### ### #
#   #               # # #     #   # #             # # # #   #     #   #   # #   #
####### ######### # ######### ### # ### ####### # ### # ### # # ##### ### # ### #
#               # # #       #   # # # #   # #   # # # #       #   #   # #   # # #
# ################# # ##### ##### # # # # # # ### # ####### ##### # ### ### # # #
#   #         #     # #               # # #     # # # #   # #   #   #           #
# ####### ### # # ######### ######### # ### # # ### # # # ##### # ### ##### #####
# #     #   # # # # # #   #   # #   # #   # # #   #     # # # # # # # # #   # # #
# # ### # ##### ### # # ### # # ### # # # ####### ### ##### # # # # # # ##### # #
# # # #   #   #   #     #   # # # #   # # # #     #   #   #   # #               #
# ### ### ### ### # ### # ##### # ### ### # ### # # ##### ### # # # # ### #######
#     #   #   # # #   #       #       # # #     # #     #         # #   #   #   #
##### # ##### # ####### ######### ### # ### ####### # # # # ####### ######### # #
# # # # #     # # #   # #     #   #     #   # #     # #   # #   #     #       # #
# # # # # # ### # ### ### ### ####### ### # # # ### ### ### # ####### ### ### ###
#         #   #   # #     #             # # # # #   #     # #           #   #   #
# ### ##### # # ### # ##### ### # # # ##### # ####### # # ##### # ### # # ### ###
# #     #   #       #     # #   # # # #         #     # #     # # #   #   #     #
######################################### #######################################

