########################### #####################################################
# #                                                 #   #               # #     #
# # ### # ##### # # ### # # ### # ####### # ##### # # # ### ### # # ### # # #####
#   # # #     # # #   # # # # # #     #   #   # # # # # #   #   # # #           #
# # # ########### ##### ##### ##### ##### ### # # ##### # ##### ### ### # #######
# # #   # #     #   #     # # #   #     #   #   #   #   # # # # # #   # # # #   #
# ### # # ### # # ####### # # # ########### ### ##### ### # # # # # ##### # # ###
# # # #     # #   # # #     # #           #   #     #         # # # #   # #     #
### ##### ##### ### # # # ### ######### ### ######### ##### # ### # # ##### # # #
#       #     # #     # # # # #   #   #   # #         #     #   #       #   # # #
# # ####### ##### ##### ### # # ##### # ### ######### ##### # # # ##### ### # ###
# # #   # # #     #   # #       #       #   # #     # # #   # # # #   # #   # # #
### ### # # ##### # ##### ### # ##### ##### # ### # # # ##### ##### # # # ### # #
#     # # #   # #   #   #   # #         #   #     #     #     #   # #       #   #
# # # # # ### # ### ### # # ##### ##### ### ### ### ### ### ### ##### # # # # # #
# # #   # #   #   #   #   # #   # #     # #     #     #   #   # #     # # # # # #
# ### # # ### # # ### ##### # ##### ### # # ####### ### ##### # # ### ####### # #
# # # # #       #   #   #   #   #     #           #   #   # # #     #   # #   # #
# # ### # # # ##### ### ### # # ##### # # ######### ### ### ######### ### # #####
#     #   # # #   #           # # #   # # #       #   # #     #           #     #
######### # # # ############### # # ######### # # # ##### # # ######### # # # ###
#   #     # # #     #         # #     #   # # # #     #   # #         # # # #   #
# # # ##### ####### ### ######### # # ### # ######### # ######### # # ###########
# #   # #     #   # #   #       # # #     #   #     # #     #   # # # # #   #   #
# ### # ######### # # # # ### # ##### ### # # ### ### # ### # ### # ### # ##### #
# #       # # #   #   # #   # #     # #     #     #   #   #   # # #   # # #     #
####### # # # ### ### ### ########### ### # # # # ### # ####### ####### # ##### #
#   #   #     # #   #     # #           # # # # #   #   #   #   #     #   #     #
### ####### # # ### ##### # # ### ##### # ### # # ##### # # # ##### ##### ##### #
#   # #   # #               #   # #     # #   # #   #     #   #                 #
### # ### ####### ### # ##### # ######### # ########### ### ####### ### # # ### #
#       #     # #   # #   # # # # # #   # # #             #         #   # #   # #
####### ### ### ####### ### ##### # # ##### ### ### # ### # ####### #############
#   # #       #   #   #     # #     # #   #   # #   #   # #   #     #   #     # #
# # # # ####### ##### # ##### ### ### # ### # ##### ### ######### # # # # ### # #
# #           #     # # #   #   #         # #     # # # # # #     # # #   #     #
####### # # ##### # # ##### ### # # # ### # ####### # # # # ### ### # ######### #
#   #   # # # #   #   # #   #     # # #   # #     #   # #   #   #   #   #     # #
# ##### ##### ### ### # # # ##### ########### ##### ##### # ####### ### # # # # #
#   #     #   #   #       #         # #                 # #     #       # # #   #
# # # ### # # # # # # ### # ### ### # ### ##### ##### ######### ##### # ##### ###
# #   # # # # # # # #   # #   # #   #     # # # #   # #     # # # #   # # #     #
####### # # ### ############# ### # ####### # # # # ##### ### # # ####### ##### #
# #   #           # #   #       # # #     # #   # # # # # #     #             # #
# ### ### # # # ### # # ##### ##### # ##### ### ### # # # ##### ### ####### ### #
# #       # # #       # #     #   #   # # #           # # # # # #     #   # # # #
# # ### ######### ### ########### ### # # ### ####### # # # # # ##### # ### # ###
# # #   #         #   # #     # # #     # #   #         #         #     #   #   #
# # ############# ##### ### ### # # ### # # ### ### ### # # # # # ### ### # ### #
#         #     # #   #   # #       #   #   #     #   #   # # # #       # #     #
##### # ### ##### # # ### # ##### # # ##### # ##################### # ### # ### #
# # # #     # #   # #     # #     # #       #     # #   # # #       #   # # #   #
# # # # ### # # ##### # # # ##### ####### # # # ### ### # # ### # ##### ####### #
#     #   # #     #   # # #   #   #       # # #   #     # # # # # # #       #   #
# # ##### ######### # ### # ### ### # # ### # # ##### ### # # # ### ##### ### ###
# #   #       #     # #           # # #   # # #   #               #         #   #
################### #############################################################

