### #############################################################################
#   #     #       #         #     #                     #       #               #
### # # # # # ############# ##### # ############# ### # ##### ##### ### # # # ###
#   # # # # #     #       #       #   # #     # # #   #     # #   # # # # # # # #
# ####### # ##### ####### ### ##### ### # ##### ### # ### # # ### ### # ##### # #
# # # # #     # #   # #     # # #     #       #   # #   # #     #       # # # # #
# # # # ### # # ### # ### ### # ##### ### ####### ##### ### ##### # ### # # ### #
# # #   #   #     #         #   #     # #     #     # # #         #   #     #   #
# # ### # ####### # # ##### ### ### # # # ##### ##### ######################### #
#   # #   # #     # #   # #     # # #   #       #     #       # #     #     #   #
# # # ### # ##### # # ### # ##### ### # ##### ####### ### # ### ##### ##### # # #
# #       #     # # # #       # #     # #     #           #   #       #     # # #
# ####### # ##### # ##### ##### ### ### ##### ####### # ##### # ####### # ### # #
#     #         # #   #       #     # #               #   #             #     # #
######### ##### ##### ### # # # ##### # ### ##### # ### ####### # ####### ### ###
#       #   #     #   #   # # #     #   # # #     # # # # #     # #       #     #
# ######### ### # # ######### # ######### ##### ### # # # ### # # # ### # ### # #
#         # #   # # # #             #   # #   # #     # #     # # #   # #   # # #
# ####### # ####### # # ##### ######### # # ####### # # ######### # ##### # # # #
# # #   #         # # # #   #     # # #   # #     # # # #     #   #   #   # # # #
### ### ##### # # # # # # # ### ### # ### # ### ##### ##### ####### ####### ### #
#   # # #     # # # #   # # # #   # # #   #   # # # #           #         #   # #
# ### # ### ######### ### ### ### # # ### ### # # # ### ### # ### ############# #
#             # #     #             #                 #   # #   #   # # # #     #
# ### # # # ### # ### # ##### # # # # ### ######### ####### ##### # # # # ##### #
#   # # # #     #   # #     # # # #     #   #       #     # #     #     #   #   #
# ########### ### ####### ### ##### # # ##### ##### # ####### ######### ### # # #
#   # # #       # #       #       # # #   # #   # #       #           #     # # #
### # # ### # ##### ##### ####### # ####### # ### ##### ####### ##### ##### # ###
#   #       #     #   #     #   # # #                 #   # #       #   #   #   #
##### # ################# ##### ##### ############# # ### # # # # ##### # ### # #
#   # # #       #     # #     #   #         #   # # #   # # # # # #   # #   # # #
### ### ### # # # ### # ####### ### ##### # ### # # # ##### # ####### ### ### # #
#         # # #   # #         #     # # # #   #     # #   #       # #   #   # # #
# ### # # # ##### # # # # ### # ### # # ####### ##### ### ####### # # ### #######
# #   # #     #     # # # #   #   #   #       # #     #     #     #   #         #
# ############### ### # ########### # # ####### ### ### ### ### # # # # ####### #
#               # #   #   #     # # #   #       #     # #       #   # #   #   # #
# # ########### ### ######### # # # # ##### ### ########### # ######### # # #####
# # #     #   #   #   #   #   # #   #   # # # #   #     # # # #         #       #
# ##### ##### # ####### ### # # ### ### # ### ### # ### # ### # ##### # # ### # #
#   #   #       #   #       # # #     # #     # # #   #     # # #     # # #   # #
# ### # ### ### ### ### ##### # ### ### ### ### # ####### # # ########### # #####
# # # #     #     #     #   # #   #   #     #       #   # # # #     #   # # #   #
# # # # # ##### # ### ##### ### ######### # ####### ### # ### ### # # ######### #
#   # # #     # #             #       #   # #   #   #   # # # #   #         #   #
##### ### # ### # # ####### ########### ##### # ### ### # # # ### ### # ### # # #
#     # # # #   # #     #         # # #       # # #         #       # # # # # # #
# # ### ############# ####### ### # # ### # ### # # # # ### # ### # ##### # ### #
# # #     # #   #   #   # # #   # #   # # # #   #   # # #   # # # #     # # #   #
# ####### # # # ### # # # # ##### # # # # ################# # # # ##### # # # # #
#   # #   # # # #   # # #     # # # # #     #           #   # #     #   #     # #
##### ### # ### # ##### ##### # # # # ##### # # ### ### ################# ##### #
#     #       #                 # # #         #   # # # #                     # #
##### # ####### ### ### # # # # # # # ### # ##### # # # # ##### # ### # ##### # #
#                 # #   # # # # # # #   # #   #   # #   #     # # #   #   #   # #
############################################################### #################

