############################################################################# ###
#                   # #   #                         # #             #           #
########### ### ### # # # # ####### # ### # ### # # # # ### ##### # # # ####### #
#   # #       #   #     # # # #   # #   # # # # # #   # # # #     #   #       # #
### # # ##### ##### # ### # # # ### # ##### # # ### ### # # ### ### ##### # ### #
#       #         # # #         #   # # #     #   # #     # #   #       # # # # #
# # ### # ### ### # # ################# # # ### # # # # # # ##### ##### ##### # #
# # #   # #     # # # #     # # #         # # # # #   # # # #     #     #   #   #
# ### ### ##### # ##### # ### # ### ### # ### ### ### ### ### # ### ### # ### # #
#   # #     # # #     # #     # #     # #       # # # # # #   # #     # #   # # #
# # ### ##### ##### ######### # # # # ##### ### # # # # # ####### ##### ### ### #
# #   # #   #           #     #   # # # #     # # # # #   #   #   #   #       # #
########### # ##### # # # # ### ####### # ####### # ### ### ### ### # # # ### # #
#               #   # # # # #     #     #     #     #       #     # #   # #   # #
# # # # ### ####### # ##### # # ### ### ### ### ##### ####### ############### ###
# # # # #   #       #   # # # # #     #   #   #   # # #       #     #       #   #
# # ##### # # ########### # # ### ##### ########### # # # ### ### # ####### ### #
# #   # # # # #       #               # #   #   #   # # # #     # #       #   # #
##### # # ### # ##### ### ### ############# # ##### ################# ##### #####
#       # # # # #           # #   # #   # #   # # # # # # #           #     # # #
# ### # ### ### ### ####### ### # # ### # ### # # # # # # # ######### # ##### # #
#   # #   #   # # #     # # #   #     #       #           # #   # # # #     #   #
# ### ##### ### # ##### # # ##### # # # # ##### ##### # # ##### # # # ### ### # #
#   # #     # # #       #   # # # # # # #       #   # # #   #         # #     # #
### # ### # # ##### # ### ### # # ####### # ##### ### ### # ### ##### # ### #####
#   #   # # #       # #         # #   # # # #   #   #   # #   # #   #   #       #
### # ### ##### # # ### # ##### # ### # # ### # # ####### ####### ##### ### #####
#   # # #   # # # #   # # #   # #       # #   #     #   # #   # #       # #     #
# ### # ### # ######### ### ### ### ### ### ##### ### ### ### # # # ### # ##### #
# #   # #   # #   #   # # # #   #     # #       # #           # # # #     #     #
# # # # # # # # # # # ### # # ######### # # # # ########### ### ####### ### ### #
# # #   # #     #   # #         #     #   # # #           #     # # # #   # #   #
# # ### ### # ########### # ### ### ############# ######### ### # # # ### ### # #
# #   #     #     #     # # #     # # # #   # #     # #   # #     #     # #   # #
# ##### # ### ####### ######### ### # # ### # # ##### ### # # ### ### ### # ### #
# #     # #             # #       # #   #       #         # # # #       #     # #
# ########### ########### ### ### # ### ##### ##### # ### ##### # ######### # # #
# # #   #   # # # #   #     # #     #           # # #   #   #     #         # # #
# # ### ### ### # ### ### ##### ### # # ### # # # # ##### ### ##### ##### # # ###
# # # #     # #         #       #     #   # # #   # #                   # # #   #
# # # # # # # # ### ### # ##################### ##### # ##### ####### # # # # ###
# #   # # #   # #   #     # #     # # # #   #     #   # #           # # # # #   #
# # # # ### # # ### ##### # # ### # # # # ### ### ### ############# # ##### # # #
# # #     # #   # #   #   #     #     #   # # #     # #         # # # # #   # # #
# # # # ######### ############### # ### ### # ### ### ### ####### # # # # # # ###
# # # #         #   #         # # #           # # #         #       #   # # #   #
# ### ### # ##### ### # ####### # ### ##### # # ### ##### ### ##### ### # # #####
#   # # # # #   #   # # #           #   #   #         #     #   #   #   # #   # #
# ##### ### ### # ##### ### ####### ####### ##### # # ### ##### ######### ### # #
#     #     #         #       #     #   #   # #   # #   #   # #     #     # #   #
# ######### ### ##### ### ############# ### # # # # # ##### # # ##### ### # ### #
# # # #   #         #   #   # # #           # # # # # #     #     # # #       # #
# # # # ##### # # ### # ### # # # # # # # # # ####### # # # # ### # # ### ### ###
#           # # # #   #   # #     # # # # #         # # # # #   # #     #   #   #
########################################################### #####################

