######################################################### #######################
#     # #     # #   # #       #     #                 #   # # # #   # #   #     #
# # ### ### # # # ### ### ### # ####### ##### # # # # ### # # # # # # ### ### # #
# #       # # #       #   #   #       #     # # # # #       #   # #   #       # #
##### ####### # ##### ### # ### ### ##### ### ### # ### ### ### # ######### ### #
#   #             #   # # #       #       #     # #   #   # #   #       #     # #
### # # # # # ##### # # # # ##### # ### ######### # # # ### # ######### # # #####
#   # # # # # #     #     #     # #   #     #     # # # #                 #     #
# # # # # ####### ######### ##### ##### ### ### ##### ####### ######### ##### ###
# #   # #     #   # # # # #     #   # #   # #   # #   #     #     #     #       #
# ### ####### ### # # # # ### ### ### ### ####### ### ### ############# ### #####
#   # # #   # # # # # # # # #   #   #       # # # #         #         # # #   # #
##### # # # ### ### # # # # # ######### ##### # # # # ######### ##### # # # # # #
#         # #     # # #         #     #       #   # # #         # #   #   # #   #
# ### ### # # ### # # ### # # ### # # ### ##### ##### ######### # ####### ##### #
# #     # #   #   #       # # #   # #         #         # # # # # # #   #   # # #
### ######### # ############# ### ######### ####### ### # # # # # # ### # # # # #
# # # # #   # # # #     #     #   #     #     # # #   #           #   # # #   # #
# # # # # # # ### # # # # # ### ####### # # ### # # ##### # ####### # # ##### # #
# #     # # # #     # #   #   #         # #     #       # #     #   #     #   # #
# ##### ### # # ####### ##### # # ##### # ### ######### # ### ####### # ### ### #
#           # # #       #   # # #     # #   #       #   # # #     #   #       # #
### # ##### ######### ### ##### ####### ### ############### ####### ######### ###
#   # # #   # #     # #           #     # # #     # # #   #   #       # #       #
# # ### ### # ### ### ### ############# # # ##### # # # ##### ##### # # ### ### #
# # # # # #         #   # #           # #   # #             #   # # #     # #   #
# # # # # ####### ######### # # ### ####### # # ############### # ### ##### #####
# # # #   #   # #     #     # # #         # #       #     # #     # #     #     #
# ### ### # # # # # ######### ######### # # ### ##### # # # ### # # # ### ##### #
# #       # #   # # #   #   #   #       # #         # # #       #     #   #     #
### # ### ##### # ### # # ### # ### ### # ##### # # ##### # ### ####### # ### # #
#   # # # #       #   #     # # # # #   # # #   # # #   # # #   #     # # #   # #
### ### # # ### # ### ##### ##### ####### # # # ### ### ######### ##### # ##### #
#   # # #   #   # # # #     # #     #       # # # #   #               # # #     #
# # # # # ##### ### # # ##### # ########### # # # ### # # # # ### # ### ### # # #
# #   #   #   #       # #       # # #   #     # #     # # # # # # # # # # # # # #
# ### ####### ##### # ### ##### # # # # ##### ############# ### ##### # # # # # #
#   #         #   # #   # #           # # # # # # # #               #     # # # #
# ### # # ####### ### # # ####### ####### # # # # # # ############# ### # # ### #
#   # # #   #   # # # #   #     # #     #   # # #       # #         #   # # # # #
# # ####### # # # # ### ##### # # ##### # ### # ##### # # ##### ##### ####### ###
# # #     # # #   #       #   #       #   # # # # #   #   #   # #       #       #
# # ##### # # # ### # ### # ### # ####### # ### # ### ### # ######### ### # #####
# # # #     # #   # # #   #   # #     #       # #   # # #   #       #     #     #
##### ### # ### # # ##### ### ### # ##### ### # # ##### # # ### ##### ##### #####
#   #   # #   # #     #   #     # # #     #   # # #       #       #   # #       #
# ##### # ############# # # # # ### # # ##### # # ### ##### # # # # # # #########
#   # #     #         # # # # #   #   # #       # #   # #   # # # # #           #
# # # ### ##### ### # ### ####### ####### ### ### # # # ######### ### ### ##### #
# #     #   # # #   # #   # #       #   # #   #   # #         # #   #   #   #   #
# # # ##### # ####### # # # # # ### ### ##### # ######### # ### # # ########### #
# # #   #     # # #   # #   # # #       #   #   #   # #   #     # # #     #     #
# ##### # # ### # # # # ##### # ####### # ### ### # # # # ##### ##### # # # ### #
#     #   #         # # #     #   #         #     #     #   #   #     # #   #   #
####################################################### #########################

