####################################################### #########################
#   #     #             #   #   #       #   #   #   #       #         # #   #   #
# # # ### ######### ##### # # ### ####### # # ##### # ##### ### ##### # ### # # #
# # #   #   #       #     #       #     # #         #   #       #   #     #   # #
# # ### # ### ####### # ######### # ##### ######### ### ######### ### ######### #
# #     #     #   #   #       #   #       #     #   #   #       #               #
# ######### ### # # # ######### ####### ### ### # ### ### ##### # ##### #########
# #   #   #     #   # #             # #   # #   # #     # # #   #   #   #       #
# # ### # ########### # ########### # ### # # ### ##### # # # ####### ######### #
#       # # # #       # #     #   # #   #   # # # #   # #   #         #         #
##### ##### # # ####### ### ### # # # # ##### # # # ### ### # ########### ##### #
# #   #       #     #   #   #   # #   #       # # # #   #   #   #       #   #   #
# # ####### ##### ### ##### ##### ####### ##### # # # # # ####### ##### # # # ###
#     #     #   # # # #   # #   #   #           # # # # #       #     # # # # # #
# # ##### ### # ### # # # # # # # # # ####### ### # # # ##### ### ### # ### # # #
# # #     #   #     # # #   # #   # # #     # #   #   #   #   # # # # #   # #   #
### # ### # # ##### # # ########### # # ### ### ######### # # # # # # ##### ### #
#   # #   # # #   # # # #           # #   #   #   #     # # # # # #   #   #   # #
# ### ##### ### # ### # # # ################# ### # ### # ### # # # ### # # # # #
# #   #     #   #   #   # # #     #   # #   #   #   #     # #     #   # #   # # #
# # ### ##### ##### ### # ##### ### # # ### ### ########### ######### # ### # ###
#   #     #   #   #     #     #     #     # #   # #   #   #   #     # #   # #   #
# ### # ##### ### # ##### ### ######### # # # ### # # # # ### # ### # ######### #
# #   # #         #     # #             # # #     # # # #   # #   # # # #       #
# # ##### # ########### # ##### ######### # # ### # # # ### # ### # # # # ##### #
# #     # # #       # # #   # #       #     #   # # #   # #   #   #   #     # # #
### ### # ### ### # # # ### # ####### ##### ### ### ##### ### # ### ####### # # #
# # # #   #   # # # # # #   #   #   #   # #   #   #       #     # #       # #   #
# # # ##### ### # # # # # ##### # # ### # ### ### ##### # # ##### ####### # #####
# # #     # #     # # #   # #     #     #   #   #       # # #             #     #
# # # ### # # ##### # ##### ### ##### ##### # ##################### ########### #
# # #   #   # # #   #       #   #   #   # # #       #     #   #     # #       # #
# # ### ##### # # ####### # # ### ##### # # # ### ####### # # # ##### # ### # # #
# #   #     #   #       # # #     #     #   # # # #     # # #   #       # # #   #
# ### ##### ### ##### ### ####### # ##### # # # # # ### # # ##### ####### # #####
#   # #   #   # #   # #   #       #   #   # # # #   #   #   #   #   # #   #   # #
### # ### ### ### # # ### # # ### ### # ### ### ##### ### # # # ### # ### ### # #
#   # # #       # # # #   # # #     # #   #     #     # # #   # #           #   #
# ### # ####### # # ### ### # ####### ####### ### ##### # ################# ### #
#   # #         # #       # # #       #     #   # #       #   #         #   #   #
# # # # ########### ### ### # ### ##### ### ### # # ####### # # ##### ####### ###
# # #   #   #       #     # # #   #     #       # #   #     #   #   # #       # #
### ##### # ### ########### # # ### ####### ##### # ### ######### # # # ####### #
#   #     #         # # #   # # # #   # # # #     #     #         # # #   #     #
# ### ####### # ##### # # ### # # ### # # # ### ########### ### ##### # # ### ###
#       #   # # #       # #   #   #   # #   # #       #   #   #     # # #   #   #
# # ### ### ##### ####### ########### # # ### ### ### # # # ##### # # ### # ### #
# #   #       #   #       # #         #   #   # # # #   # # #   # #     # #   # #
# ### ####### # # ####### # # ### ####### # # # ### ##### # # # ####### ### # # #
#   # #   #   # #   #   # # #   # #     # # #   #       # # # #     # #     # # #
# # # # # # # # ##### # # # ### # # ### # # # ### ### # # ### ##### # ##### # # #
# # #   # # #   #     #   #   # #   # # #   # #   #   # #   # # #   #   #   #   #
### ##### ####### ########### # ### # # ##### # ### ####### # # # ### ### ##### #
# #   #   #       #       #   # # # # # #   # #   # #     # # # #   #     # # # #
# ### # ### ####### ### ##### # # ### # # # ##### # # # ### # # ### ####### # # #
#     #         #     #               #   #       #   #       #             #   #
################################################# ###############################

