##### ###########################################################################
# #     #     #             #             #         #   #   #                   #
# # ### # # ### ### ######### ######### ### ##### # # # # # ######### ####### ###
#   # #   #     # #     #     # #   #   #     #   #   #   #   #       #     #   #
# ### # ######### ##### # # ### # ### ### ### ### ########### # # ####### # ### #
# #   # #       # #   #   # #       #       #   #   #     # #   # #     # #   # #
# # ### ####### # # # # ### ### ######### ##### ### # ### # ##### # ##### # # # #
# #   #         #   # # #       #   #   # #       # #   #     # # #     # # # # #
# # # ############# # # ##### # # ### # ### # ##### # # ##### # # ##### # ### # #
# # #   # #   #   # # #   #   # # #   #     # # #   # # # #   # #     #     #   #
# ### # # # # # # ### ### ####### # ########### ### ### # # ### ##### ##### #####
# #   #   # #   #     #   #     # #               #     #   #       #   #       #
# # ##### # ######### # ####### # ########### ########### ##### ####### #########
#   # #   #     #   # #   # #   #           #       #   # #   #       #         #
##### # ### ### # ### ### # # # ######### # ####### ### # # # ### ### ####### ###
#     #   # # # #       # # # # #       # # #     #   #   # #   # #         #   #
# ### ### ### # ### ##### # # ### ##### ### # # ##### ### # ### ### ########### #
# # #   # #   #   # #     #       #   # #     #   #     #   # # #   #   # #   # #
# # ### # ### # ##### ####### ##### ### # ### ### # ### ##### # # ### # # ### # #
#     # # # # #       # #   # #     #   # # #   # #   #       #   #   # #   # # #
##### # # # # ######### # # ####### # ### # ### # # # ############# ### # # # # #
#   # #   #     #       # #         #   # #     # # # #           #   #   #   # #
# ### ##### ### ### ##### # ### ####### # ####### # # # ######### ### # ####### #
#     #     # #   # #     # #   #     #     #   #   # # #     #     # # #     # #
# ####### ### ### # # ##### # ### ### ### # # # ### # # ##### # ##### # # ##### #
#         #     #   # # #   #   #   #     # # # #   # # #     # #     # # #     #
############# # ### # # # ######### ##### # # # ### # # # ##### # # ### # # #####
#   #       # #     #   # #       # # #   #   #   # #   #       # # #   # #     #
# # # ##### # ####### # # # ### ### # # ######### # ##### ######### ### # ##### #
# # #     # # # #   # # # # # #   #   # #     #   #     #         #   #   # #   #
# # # ##### # # # # ##### # # ####### # # ### # ####### ######### ### ### # # ###
# # # #     #   # #   # #         #   # # #   #   # #   #   #   #   # #   # # # #
# # # # ######### # # # ####### # # ### # # ##### # ### ### ### # ### ##### # # #
# #   #   #   #   # #   # # # # #   # # # #   #   #   #     #   #     #     #   #
######### # # # ####### # # # # # ### # # ### # ##### ####### ### ##### # # ### #
# #     #   # # #     #   # #   # #     # # #       # # #       #   # # # # # # #
# # ### ##### # # ### ##### ### ### ####### ######### # # ##### # ### # # # # # #
#   #   # #       # #     # # # #   #       # #       #   # #   # #   # # #   # #
# ### ### # ####### ##### # # # ### # ####### # ####### ### ### # # # ### ### ###
# #   #   #       #     # #   # #   #                 # # #   #   # #     # #   #
### ### # # ####### # ### ### ### ##### ############# # # # # ##### ####### ### #
#       # # #     # #           #     #   #     #     # #   #   #       # #     #
# ######### # ### # ########### ##### ### # ### # ##### ##### # ##### # # # #####
#   # #       # # #   #       #         # # #   #   #     #   #   # # # #       #
# # # ######### # ##### ##### ##### ### # # # ##### ##### # # ### # ### ####### #
# # #     #   #       # #   #   #   # #   # #   #   #       # #   #     #     # #
# # ##### # # # ##### # # # ### # ### ##### # ### ############### # ##### # # # #
# #         # # #   #   # #     #     #     # #   # #     #     #   #     # # # #
# ######### ### # # ##### ### ##### ### ##### # # # # ### ### # ##### ####### # #
# #   #         # # #   # # #     # #   # # # # #   #   #   # # #     #     # # #
### # # ######### ### # # # ##### ### # # # # # ##### ##### ### # # ### ### ### #
#   # # # #     #   # # # #     #   # # # # # # #     #   #   # # #     # #   # #
### ### # # # # # ### # # ##### ### # # # # ### # ### # # ### # # ####### ### # #
#       #   # #       #           #   #   #       #     #   #   #           #   #
####################### #########################################################

