################### #############################################################
#     #         #         #       #   #           #   #           # #   #       #
# ### # ####### # ### ##### # ##### # ##### # ### ### # ### ##### # ### ### #####
# #   #   #       #   #     #       # #   # # #       #   # # #     #     # # # #
# ### ### ### ####### # ############# # # # # ######### # ### # ### # ### # # # #
#   #   # # #   #   # # #   #       #   # # #           #   #     #   #   # #   #
### # ### # ### # ### # # # # ######### # ### ############# ####### ##### # # # #
#   # #       # # #     # #           # # #           #   # #     # # # #     # #
# ##### ##### # # ####### ########### # # ######### ### # # # # # # # # ##### ###
#     #     # #       # # #       #   # #   #   #     # # #   # # # #         # #
# ### ##### ########### # ##### ##### ### ### # ##### # # # ### ### # ####### # #
#   # #     #       #       #   # #   #     # #     #   # # #   #   #     # #   #
### # # ##### ##### # ####### # # ### # # ### ############### ### ### ##### # ###
# # #   #   # # #   #   #     #     # # #   #   # # #   #     #   #   #     # # #
# # ##### # # # # ### # # ### ####### # ### ### # # # # ### ### ### ### ### ### #
# #   #   # # #   #   #   #   #     #   #   #   #     #   # #   #   #   # #     #
# ### # # ### # ##### ##### ### ### ##### ### ##### ##### # # ##### # ### ##### #
# #     # #   # #     #   # #     # #     #         #       # #   # # #       # #
# # ##### # # ### ####### # # ##### ####### ######### # ##### # # ### # ##### # #
#     #   # # #   #   #   #   # #           #   #     # #   # # #     # #   #   #
# ######### ### ### ##### ##### # ############# ### ####### # # # ##### # #######
#   #     # #   #   #   #       # #   #           #         #   #   # # # #     #
# ### ### # # ##### ### # ####### # # # ####### # ####### ##### ##### # # # ### #
# #   # # #   #     #       # #   # # # #     # # #     # #   #     #   #   #   #
# # ### ##### # ### # ##### # # ### # # # ### ### # ####### ####### # ####### ###
# #   #     #   #   # #   #   #   # # # # # #   #   #         #     #   #   #   #
##### # # ##### ##### ### ### ### # # # # # # ####### ####### # ####### # # # ###
#     # # #     #       # # #     # #   # #         #     #   #   #     # #   # #
# ##### ### ##### ### # # # # ##### ### # ### ##### # ####### # # # ##### ##### #
#   #       #       # #     # #     #   # # # #   # # #   # #   # # #       #   #
### # ####### ####### # ####### ######### # ### ### # # # # ##### # # ##### # # #
# #   #     #   #     # #   #         #   # #   #   #   #       # # # #     # # #
# ##### ### ### # # ##### # ######### # ### # ### # ########### # # ### ##### ###
# #   # # #   # # #     # #         # # #   #     # # #   #   # # # #   # #     #
# # # # # ### # ####### # ### ##### # # # ### ####### ### # # # ### # ### # ### #
#   # #     #     # # #     # #     #   # #   #       #     # # #   # #     #   #
# # # ##### ##### # # ######### # ### ### ### ### # ### # ### # # ### # ##### # #
# # #     # #   #   #   #     # #           #     # #   #   # # # #   # #     # #
### ##### ##### ##### # ### ### ### ############### # ##### # # # # ##### ### # #
#   #     #   #   #   #       #   # #       #   #   # #   # #   # #   #   # # # #
# ### ####### ### # ######### ### ### ######### ##### # # ####### # ### ### ### #
# # # #         # #   #     # # # #       #   #     #   # #   #   #   #   #     #
# # # # ##### ### # ### ### # # # # ##### # # ##### ####### # # ##### ### # #####
#   # #   # # #   #   #   #   # #   #     # #       #       # #       #   #     #
##### # # # # # ##### # ####### ##### # ### ##### ####### ### ### ##### ####### #
#     # # #   #       #   #       # # #   #   #   #       #   #   #     # #     #
# ####### # ### ##### ########### # # ### # ### # # ########### ### ##### # #####
#       # # #       #     #   #   #   # # # #   # #   #           #   #   # #   #
####### # ##### # ####### # # # # # ### # # # ### ### # ######### ### # # # ### #
#   #   #   # # #   #   #   # # # #     #   # #     #       # #   # # # #       #
# # # ### # # ####### # ##### # ### ### ##### ### ### ##### # # ### # # ### # ###
# # #   # #     #     #   #   #     #       #   # #   #   # #   #     # # # #   #
# ##### ####### # ####### # ######### ######### # ##### ### ######### # # # # # #
#     # #         #     # #       # # #   #   # #   #     #   #     # #   # # # #
# ### # # ### ####### ### ### ### # ### # # # # ##### # # ### # ### # # # ##### #
#   #     #             #     #         #   #   #     # #       #     # #   #   #
######### #######################################################################

