############################### #################################################
#             #       #     #     #     #       #     #         #   #     #     #
# ##### ##### ####### # ### ### # ### # # ##### # # ####### ### ### # # ### #####
#   #     #   #     #   #     # # #   # #   #   # #         #       # # #       #
######### # ### ### # ####### # # # ### # ### ##### ##### ### ######### ### ### #
# #     # #     # #         #   # #   #   # # #   # # #   #   #   #     #     # #
# # ### # ####### # ####### # ### # # ### # ### # # # # ####### # # ### ####### #
#   # # #     #   # #   #   #   # # # # #   #   # # # #       # #   #   #   #   #
##### # ##### ### # # ### ####### # ### ### ### # # # ####### # ##### # # # # ###
#   # #     # #     #         # #       # #     # #       #   # #   # # # #   # #
# ### ### # ### ####### ### ### ####### # ####### ####### # # # # # ### # # ### #
#   #   # # #   #     # #   #         # # #     #       # # # # # #   # # #     #
### # # # ### ####### ### ##### ### # ### ##### ####### ### ### ##### # # ##### #
#   # # #   #     # #       #     # #     #   #           #   #     #   #     # #
### ### # # ##### # # ####### ############### ### ####### ### ##### ### ##### # #
#         #       # # # #     #   #   #     # # # #         #     #   #   #   # #
# ### ######### ### # # # ####### # # # ### # # ####### ##### ####### ### # #####
#   # #     # #     # #       #   # #   # #       #   #     #   #   #   # #     #
### # # # ### # ##### ####### # # # ##### ####### # # ##### ### ### ### # # ### #
#   # # #     #     #     #   # # #   #     #   # # #   #   #   #   #   # # #   #
# ##### ##### ##### ##### # ### # # # # ### ### # ##### # ### ### # # ### ### ###
#       #     #     #       #   # # # #   #     #   # #   #   #   # #   #   #   #
### ##### ### # ##### # # # # # ### ### # ### ##### # ### ### # ### ### # ##### #
#   # #     # # #   # # # # # # #   #   # #   # #   #   #   #   # #   # # #     #
# ### # ##### ### # ####### # # # ##### ####### # ##### ### # ### ### # # # ### #
# #     #     # # #   #     # #         #     #   # #       #     #   # #   #   #
# ##### # ##### ### ### ######### ### ### ##### # # # ########### # ### ### #####
# # #   #     #   #   #       #   #       # # # # #   #     #   # #   # #   #   #
# # ######### # ##### ####### ### ### ##### # ### ### # ### ### # ### # ##### # #
# #         #       #     # # #   # # #       #     #   # #   #     # # #     # #
# ### ############# ### # # # # ### ##### ######### ##### ### ####### # # ### # #
#   #       # #   #     #   #   # #   #             # #               # # # # # #
# ### ### # # ### ####### # # # # ### # ############# ############### # # # ### #
#     # # #     # #   #   # # # #   #   #       # # #   #     #       # # #   # #
##### # # # ##### # ######### ### ##### ##### # # # # ### # ########### # # # # #
# #     # #       #           #     # #       #         # #         #     # # # #
# # ### ####### ####### ##### # ### # ##### ########### ####### ### ####### ### #
#   # # # #   # #     #   #   #   #     #   #   #     #         # # #   #   #   #
# ### ### # # ##### # ##### ##### # # ######### # ### ########### # # # ### # # #
# #   # # # #       # #     #     # #   #     #   # #     #       #   # #     # #
# # # # # # ######### # # ### # ####### # # # # ### ##### ##### # ##### # ##### #
# # # # # #     # #   # #   # #   #       # #   #       #       # #     #   #   #
# ### # # ####### # ### ##### ##### # ################# ####### ### ### ### #####
#   # # # #         #           # # # #     #   #     #         #   # #   #     #
### # # # # ### # ########### ### ### # # ### ### ### ######### ##### ### # ### #
# #   #       # # #     #   #   #     # #   #   # #   #       # #   #   # #   # #
# ### ######### # # ### # # ### ####### ### ### # ### # # ##### # # # # # ##### #
#   # #       # # # #   # #           #   #   #   #   # # #   # # #   # # #   # #
# ### # # ##### # ### ### ####### ### ### ### # ##### # ### # # ####### # # # # #
# #   # #       # #       #     # # # #   #   #   #   # #   # #   #   # #   #   #
# # ### ################### ### # # # # ### ##### ### # # ### ### # # # #########
#   #     #   #         #   #       # # #       #   #   # # # #     #   #   #   #
# ####### # # # ##### ### ########### # ####### ### ##### # # # ####### # # # ###
#       #   #       #               #     #         #       #       #     #     #
##################################### ###########################################

