####################################################################### #########
#   # #                   #           #       #   #       #       #   #     #   #
### # # ### ########### ### # ####### ##### # # # # ### # # # ##### # # # # # # #
#   #   #   #     #   #     #     # #   # # #   #   # # # # #       #   # #   # #
# ##### ##### ### # # ########### # # # # # ######### # # ######### ##### ##### #
#     #   #   # #   #           # # # #   #           # #         #     #     # #
### # ##### ### ############### # # # ############### # ######### ##### ##### ###
#   #       # #             #   # # #       #       # #   # # # # #   #     #   #
### ### ##### # ##### ### ### ### # ##### # # ### # # ### # # # # # # ### ##### #
#   #     #   #     # #   #   # # #       # # # # # # # #     #     # # # #     #
# ### ### # # ##### # ##### ### ### ##### # # # # ### # ### ### ##### # ### ### #
#   # # # # # #     #         #       #   # # # #   # #   # # # #   # #     # # #
####### # # ### ####### ##### # ### ### ### # # ### # # # # # ### ### ### ### # #
#     #   #     # #   #   #   #   # #     # #   # # #   # # #       #     #   # #
# ### # ######### # # ### ####### # ##### ##### # # ### ### # ##### ####### ### #
# #   #       #   # # #       #   #     #   #     #   # #   #   #           #   #
# ########### # ### # # ##### # ### ### ### ####### # # # ### ### ######### # ###
# #           #     #   #   #   #     #   #       # #   # # # #   #         # # #
# ### ################# # ########### # # # ##### # ##### # # # ### ### ##### # #
#   # #             #     #         # # # # #     #   #   #   #   # # # # #   # #
# ### # ####### ### # ##### ####### ### # ##### ####### ### ### # # # ### # ### #
#     #   # #     # #   #     #   # #   # #   #     #   # #   # # #       #     #
### ##### # ### ####### # ### ### # # ### # # ### ### ### # ##### ##### ####### #
# # #   # #   # #       #   # #   # # # #   #   #     # #   #   #     # #   #   #
# ### ### ### # # ######### # ### # # # ##### ##### ### # ### # ##### ### # # ###
# #     #   # # # # #   #   #     # # #     # #   # #     #   #     #     #   # #
# ### # ### # # # # # ####### ### # # # ##### # # # # ##### ################### #
#   # #   # # #   #   #       #   #   #       # # # # #     #       # # #   #   #
# ### ### # # ##### ### ####### ####### ######### # # ### ### ##### # # # ### # #
#   #   #   #     #     #   # #     # #         #   # #   #   #     #         # #
# # ### ### ### # ##### # ### ### ### ##### ### ##### # # ##### ######### ##### #
# # #     # #   #   #     #   #   # #         #   #     # #   #   #     # #   # #
### # ##### # ##### # ##### # # ### ##### ############### # ##### ### # # # # ###
#   # #     # #     # # #   #         # # #     #     #     #     #   # #   #   #
# ### # ##### # ##### # # ############# ### ### # ### ####### ##### ### ####### #
#     #       #   # #   # #             #   #   # #   #       #       #     # # #
# ####### ####### # ##### ### ### ### ### ##### # # ### ### ### ### ####### # # #
# # # #   # #     #     #       # # #   #     #   #     #   #   #   #   #     # #
# # # # ### ####### # ########### # ### ##### ########### ####### ### # # ##### #
# #   # #     # #   #         #       #   #           #     #     #   # # #     #
# # # # # # ### # ##### ##### # ### # ### ### # ##### ##### # ####### ### # #####
# # # #   # #     # #       # #   # #   #   # # #     # #   # #       #   #     #
# # ####### ### ### ####### # ### # ####### ### # ### # ### # ### # ### ### ### #
#   #       # # # #     #   #   # # #           #   # #   # #   # #     #   #   #
# # ### ##### # # # # ### ### ### ############# # # ### # # ### ### ### # ##### #
# # #   #     # # # #       #       #     #     # #     # # #     #   # #     # #
### # ##### ### # # ####### ######### # ### ############# # ##### # ##### ##### #
#   # #     #   # #   #     #   # #   #       #       #   #       # #     #     #
##### # ### # ### ### ####### # # # ##### ### # ##### ############# # ##### #####
# #     #   # # #   #         # # # #   # #       # # #   #       # #     # #   #
# ####### ### # ### ########### # # # # # ####### # # ### ####### # ####### # # #
#   #   # # #   #   # #     # #   #   # #   #     # #     #     # #     #     # #
# # # ### # ### # ### # ### # # ##### ##### # ### # ##### ##### # ############# #
# #   #   #   # #       #   #   #     # # # # # #     #       #                 #
# ##### ### # ##### ##### ####### ##### # ### # ##### # ####### ############### #
#           #   #       #             #       #       #         #               #
################# ###############################################################

