################### #############################################################
# #             #   #         #     #           #         #         #     #     #
# # ######### # # ### ### ### # ### ### ### ### # ##### ### ####### ### # # ### #
#     #   # # # # #   # #   # #   #   # # #   #   #     #       #   #   # #   # #
### ### # # # # # # ### ### ### # # ### # ### ##### ##### ##### # ##### ##### ###
#   # # # # # # #   #     #   # # #     # # #   # #     # #     # #         # # #
### # # # # # ### ##### # ### # # ##### # # ### # ##### # ####### ### ##### # # #
# #   # # # #   # #   # # #   # #   #         # #       #   #   #   # #   #   # #
# # # # # # # ##### # # # # ### ### ######### # ##### ##### # # ### # # # ##### #
# # # # #   #   #   # # # #   # # #   #     # # #   # #     # # #     # #       #
# # ### ##### # # ### # ##### # # ### # ### # # # ### # ##### # ####### ####### #
#   # #       #   # #     # # #   # #   #   # # # #   # #   # #     #   #     # #
# ### ### ### ### # ####### # ### # ### # ##### # ### # # # # ##### # ##### ### #
# # #       #   #       #       #   #   # # #   #   # # # # #   # # #       #   #
# # # ##### ####### ### ### # ### ### ### # # ### # ### # # ### # # # ##### # ###
# # # #   #     #   # # #   #     #   #     # #   # #   # #     # # # # # # #   #
# # # # # # ### # ### # ##### ##### ### ##### # ### # # # ####### # ### # # ### #
#   #   # # # # #   #       # #     # # #     # #     #   #         #   #   #   #
### # ### ### # ### ##### # # # ##### # # ####### ######### ##### ### ##### # ###
#   # # # #   # # # #     # # # #     # # #     #     #     #   # #   #     #   #
##### # # # ### # # # ##### ### # ### # # # ######### # ####### ### # ######### #
#     #   # #   #   # #   # #   # #   # # #     #     #     #     # #   #   #   #
# ##### ### ### ### # ### # # ##### ### # ##### # ####### ### ### # # ### # ### #
# #     #     #   # #     #   #     #   #     # # #   #     # # # # # #   #     #
### ##### # ####### ############# # ### # ##### # # # ##### # # # ### ### #######
#   #     # #     # #       #     #   # #       #   #     #   # #   #   # #   # #
# ### ####### ### # # ### # # ##### ### ### ############# ### # ### ### # # ### #
# #   #     #   #   # #   # # #   #     # #   #         # # # # #   #   #       #
# # ### ### ### ##### # # ### ### ####### ### # ####### # # # # # ### # ####### #
#   #   # #   #   #   # # #   #           # # #       # #   # # #   # #   #   # #
##### ### ### ### ##### # # ### ######### # # ####### # # # # # ### # ### # # # #
#     #     #     #     # # #   #   # #     #   #     #   # # #   #   # #   # # #
# ##### ####### ### ####### ### # # # ######### # ### ####### # ####### ##### # #
#       # #     # #         #   # # #         #   # # #   #   #       #     #   #
##### ### # # ### ########### ### # ### # # ####### ### # # ### ### ### # ##### #
#     #     # #   #     #       # # #   # #         #   #     # # # #   #       #
### ##### ##### ####### ### ##### # # ### ### ##### # ####### # # # ### # #######
# # # # # #       #       #   #   # # # # #   # #   #       # #   #     #   #   #
# ### # # ##### # # # ##### # # ####### # # ### # ##### ##### ############# # ###
# #     # #   # #   #       # #     #   # #     #     #     #           # # #   #
# # ### # # ##### ######### # # ### ### # ### # # ######### ########### # # # # #
#     # # #     #       # # # # # #   #   #   # # #       #       #   # # # # # #
####### # # ### ####### # ### # # ### # ####### ### ### # ####### # ### # # # # #
#       # #   # #   #   #   # # #   # #   #   #     #   # #     # # # # # # # # #
# ##### # # # # # # # ##### # # ### # # ### # ####### ##### ### # # # # # # ### #
#   # # # # # # # # #   #   #   #   # #     #     # # #       # #     # # # #   #
### # # # # # # # ### ### ##### # ### ########### # # # ##### # ##### # # # # ###
# #   #   # # # #         #     # # #     #         #   #   # #     # # # # # # #
# ### ##### ### ####### ### ##### # # ### ######### ##### # ##### # # ### # # # #
# # # #       #     #   #   #     #   #   #     # #   #   #   #   # #   #       #
# # # ############# ##### # # # ### ### ### ##### ### # ### # # ### ### #########
#     #         #         # # # #     # #   #       # # #   #   # # #           #
# ##### ####### ##### ### ### # # ##### ### # ### # # # ######### ############# #
#   # #   #     #       # #   # # #   #   # #   # # # # #   #   #         #     #
### # # ### ############# # ### ### # ### # ### # # # # # # # # # # ##### ### ###
#         #               #   #     #       #   # #   #   #   #   #     #       #
##### ###########################################################################

