####################### #########################################################
#           #   #                 #       #     #     #   #   #           #     #
# ######### # # # ##### ### ########### # # # # # ### # # # # ##### ####### #####
#   #     # # #   #   #   # #   #     # #   # # #   # # #   #     #             #
### ##### # # ### # # ##### # # # ### # ##### ##### # ########### # ##### ##### #
# #       # #   # # #   #   # #   #   #   #   #   # #   #   #   #   #   #   #   #
# # # ########### # ### ##### ##### ### ### ### # # ### # # # # ##### # ##### ###
# # # #     #         #       #   # #   #   #   # # # #   # # #       #       # #
# # ### ### # ##### ########### # # # ### ### ### # # ##### ########### ####### #
# #     # #   # #   #       #   # # # # #     # #   #     # #     #     #   #   #
# ####### ##### # ######### # ### # # # ####### ### ##### # # ### # ####### ### #
#   #   #   #     # #         # # # #       # # # # #   #   # #   #   #       # #
# # # # ### # ##### ########### # # ##### ### # # ### # # ### # ##### # # ### # #
# #   #     #   #     # #     # #     #   #     #     #   #   # #   # # # #   # #
# # ####### ### # # ### # ### # # ####### ### # ####### ### # # # # # # # # ### #
# # #   # #   # # #         #   # #     #     #     #   #   # #   #   # # #     #
# ### # # # ### # ##### ####### # ### ##### ####### ### # ############### ##### #
#     #   # #   #     #   #   # # #   #   # #       # #         #         #     #
####### # # # ##### ##### # ### # # # ### ### ####### ######### ### ####### #####
#       # #   #     #     #   # #   #   #     #   #       #     #     # #   #   #
# ################# # ##### # # ######### ##### # # # ##### ##### ##### # ### ###
#   # #           # #     # #       #   #   #   #   # #           # #         # #
# ### # ### # ### ### ### # ####### # # ### # ####### # # ######### # ######### #
#   #   # # # # #   # # # # #   #   # # #   # #   #   # # #               #     #
# # ##### ### # ### # # # # # ####### ### ### # # ##### # ######### ### ### ### #
# # #       #     # #   # # #           #   #   # #     # #       # # # #   # # #
# # # ##### ##### # ##### # ####### ####### ##### # ##### # ##### ### ### ### # #
# # #   #   #     #       #         #     #     # # #   # #     #   #     #   # #
# # # # # ### ############### ##### # # # ##### # # ### # # ### ### # ##### # # #
# #   # #   # #         #   #     #   # # #   #   #   #   #   #   #   #   # # # #
########### # # ### # ##### ##### ### # ### # ####### # ####### # ##### ##### # #
# # #       #   # # # #   #     # # # # #   # # #   # #       # #     # #     # #
# # # ######### # ##### ### # ### # # # # ### # # # # ##### ### ##### # # # # # #
#   # #             #       # #   # # # # # #   # # # #   # #   #     #   # # # #
### # ##### ### # # # # ##### ##### # # # # # ### # # ### # ##### ######### ### #
#   #     # #   # # # # #   # #   #   #   #   #   #   #   #     # #     #   #   #
# ##### # ### ######### # # ### # ### ######### ####### ##### # # # # # ### # ###
#   #   # # # #       #   # #   #   # #         #     # #     #   # # #     #   #
### # ### # # ### ### ##### # ##### ##### ######### # # # ########### # ### ### #
#   #   #     #   # #     #     #   #   # #   #     #   #       #   # # #     # #
# ##### ##### # ### ### ####### ####### # # # # ####### ####### # ### # ### ### #
#     #     # #   #   #     # #       #   # #   #   #     #     #   # #   # #   #
##### ##### ##### ### ##### # # ##### # ##### # # # # ####### ### # # ### # # ###
#     #     #   # #   #   # # #     # # #   # #   # #     # # #   #   # # # #   #
# ##### ##### # # # # # ### # ##### ### # # # ##### ### # # ### ####### # ##### #
#     # #   # # #   # #     #     # #   # #   # #     # # #   # #     #   #   # #
##### # # # # ####### # ##### # ### # ### ##### ##### ##### ### ### # # ### # # #
#     # # #   # #     # #     #         # #     #   #     #         # #     #   #
# ##### # # ### # ##### ####### ##### # # # # ### # ##### ########### ####### ###
# #       #   # # #   # #     #   #   #     # #   #     #     #     # #     # # #
# ### ####### # # ### # # ### ### ####### ##### ### # ### ### # ##### ### # ### #
#   #   #   #     #   # # # #   # #   #   #     # # #   #   # # # #     # # #   #
# ##### # # ####### ### # # # # ### # ##### ##### # ### ##### # # # ### # # # # #
#       # #                 # #     #       #         #       #       #   #   # #
################# ###############################################################

