####################### #########################################################
# #   #       #   #   #   #       # #               # #   # #   #       # #   # #
# # # ### ### # # # # # ### ####### # ##### ####### # # # # # ### # ##### # # # #
# # #   # # # # #   # # #     # #     #   # #   #       #   #     #       # #   #
# # # ### # # # # ### # ##### # # ##### # ### # # ########### ######### # # ### #
#   #     # #   #   # #     #   # #     # #   #   #         # #     #   # #   # #
# ####### # ####### # ### ##### ### ##### # ##### ### ##### # ### # # ### ### # #
#   #   #       #   #   #     # # # #       #     #   #   # #     # # #       # #
### ### ##### ### ##### # ##### # # ####### # ##### ##### # ####### # ### # ### #
#           # # #     #       # #     #   # #   #   # #             # #   # #   #
# ######### # # # ##### ##### # # ### # # ####### ### # ############# ####### ###
# #   # #   # #   #   # #   # # #   #   #       # #   #       #   #         #   #
# # # # # # # ##### # ### # # # ########### ### # # # ### # ### # # ########### #
# # # #   # #   #   #     # # #     #       # #   # #   # # #   #   # # # #     #
### # ##### ### # ######### # ##### # # ##### ####### # # ##### ##### # # #######
#   #     #   # # # #     # # #   # # #     #       # #     # #   #       #     #
# ##### # # ### # # # ### # # ### # # ##### # ##### # # ### # ### # # ##### ### #
#   #   # # #   #     #   #   #   #   #     # #   # # #   #   #   # #     # # # #
### # ### ##### ####### # ##### ####### ##### ### # ########### ### ##### # # # #
#   #   #   #   # #     #       #       #         # #   #       #     # #   # # #
### ####### # ### ### ### ##### ### ##### ######### # # # ### ####### # ##### # #
#     # # #   #     # #   #   # # # #     # #   #     # # #   #     #   #   #   #
##### # # ##### ### # ##### # ### ##### ### # # # ##### # # # # ### ### # # ### #
#   #     #     #   # #   # #       # #     # #   # #   # # # # #     # # #     #
### ##### # # # ##### ### # ### ### # ### ### ##### # ### ##### # ### ### ### ###
#     # #   # # #       # # # #   # #     # # # #     #   #     #   #   #   # # #
# ### # ##### ##### ### # # # # # ### ##### # # ### ### ### ### ### ### # ### # #
# #   #     #     #   #   #   # # #   #     #     #   #   #   # #     # # # # # #
# # ### ### ##### ### ####### ### # ####### ##### ### # # # ##### ### # # # # # #
# #     # #   #   # #         # #   #           #   # # #     #   # # # # #   # #
# ##### # ##### ### # ### ##### ######### ##### ### ### ####### ### # # # # ### #
#     # #       #   #   #     #     #     #   # #   #       #   #     #   #     #
# ### # ######### # ### ##### # # ### ##### ### ### ####### # # ### ####### #####
# #   #     #     #   # # # # # # #   #     #   # #     #   # # # #   # #       #
# # ####### # # ##### # # # # ### # ####### # ### ##### ### # # # ### # # ##### #
# #   #   # # #   #   # #   # #           # #   # #   # #   # # #   #   # #   # #
# ### # # ### ##### ### # # # # ######### # ### # # ### ##### # ### ### ### # ###
# #   # #   #     #   # # #   #     #     #     #   #     #   #   #   # #   # # #
# # ### ##### ### # ### # ### ##### ######### ##### # ##### ##### ### ### ### # #
# #   #         # # # # # #     # # # #     #       # #     # #     # #     # # #
# # # ########### # # # ####### # # # # # # # ####### ### ### ####### # ##### # #
# # # #   #   #   #   #   # #     # #   # # # #       #   #     #   #     #   # #
### # # # # # # ######### # ##### # ### # # ### ##### # # ##### # # ####### ### #
#   # # #   # #           #       #   # # #     #   #   # #     # # #       #   #
##### # ##### ##### ########### ##### ##### ##### # ##### # ##### ### ######### #
#     #   #   #   # #     #   #   # # #     #     #     #   # #     # #         #
# ### # ### ### # ####### # # ##### # # ##### ####### ### ### # # # # ##### #####
# #   # #   #   #     #   # #         #   # #       # #         # #   #   #     #
# ##### # ##### ##### # ### ######### ### # ####### # # ######### ### # # # ### #
# #   # #     #   #   #   # #         #   #         # #     #   # # #   # # #   #
# ### # ##### ### # ##### # ######### # ### # ############# # ### # ##### ### # #
#   #     # #     #   #       # #   # #   # # #     #   #   #   # #   #       # #
# # ##### # ##### ### # ####### # # ##### # # ### # # # # # # # # # # # ####### #
# #             #   #             #       # #     #   #   # # #     # #   #     #
####################################################################### #########

