############################################################################# ###
#   #         #       #           # #     #     #                     #   #     #
# ### ########### # ### ### ##### # # ### # ### ################### # # # # # # #
#   #   #       # #   #   # # #   #     # # # # #     #     #   #   # # #   # # #
# # ### # ##### ### # ### ### # ####### # # # ### # ##### # # # # # ######### ###
# # #   # # #   # # #   # #   #   # #   # #     # #   #   #   # # #     #       #
# # ### # # # ### ### # # # # ### # # ### ### # # ### # ####### # ##### ####### #
# #   #     #         # # # #   #     #   #   #   # #         #     #   #     # #
### # ########### ##### # # ########### ####### ### # ############# ### ### ### #
#   # #           #     # #       #   #       #     # #           # #   # #     #
### ### ########### ##### ####### # # ####### ########### ####### ### # # # ### #
#     # #     #   #   #   #     #   # #   # #       #           #     #   #   # #
# # ### ##### # # # ### ### ### ##### ### # ####### # # ####### ############# # #
# # #       #   #   #   #     #         #   #     # # # #     # #     #       # #
# ######### ##### ### # # ############# ### # # # # # ### ### # # ### # ####### #
#         #     # #   # # #   # #     #   #   # # # # # # #     # #   #   # #   #
# ##### # ##### # # ### ### # # # ### ### ##### # # ### # ##### ### ##### # # ###
#   #   #     # # #   #     #   # #     #   #   # #     #     # #   #   # #     #
########### ### ##### ######### # ##### ### # ### ### ####### ### ##### # #######
#         #   #   #           # #     #     # # #   # # #   # #     #   #   #   #
# ####### ### ### # ########### ##### ##### # # ### ### ### # # # ### ##### # # #
#   # #     #   #   #       #       #     # # #           #   # # #   #   #   # #
### # ##### # # ##### ##### ### ### # ### # # ########### ### # # # ### ####### #
#   # #     # #     #     #   # #   #   # # #     #   #   #   # #   # #   #     #
# # # ### ##### ######### ####### ####### ####### # # ##### ####### # # # # #####
# # # #   #   #     #   # # # # #       #       # # # #   #   #     # # # #     #
# ### # ### ####### # ### # # # ####### # ##### # # # # # ### # ### # ### ##### #
#   #   #           # #   #       #     #   # #   # #   #   # # # # #   #       #
### ### ### ### ##### ### # ####### ### ##### # ### ####### # # # # ### # ##### #
#     #   #   #   #     #   #     #   #       #   # #     #   #   # #     #   # #
# ####### ### ### ### ##### # ### ### ####### # # # # # # ##### ### # # ### # # #
# #       #     # # #       #   #   # #       # #   # # # #   # #   # #     # # #
# ### ########### # # ##### ### ### # ##### ### ##### # ### ### # # # ####### # #
#   #   #     #   #   #     #   # #     #   #   #     #   #   # # # #       # # #
# ##### ### # # ####### ##### ### ##### ### # ### # ##### # # # # ##### ##### ###
# #       # #   #     #       #           # # #   #   # # # #   #   # #     #   #
# ####### # ### # ### ####### # ########### # ####### # # # ##### # # ##### # ###
# #     #   #   #   #       # # #     #   # #   #     # #   #   # # # #     #   #
# # ### ### # # ### # ##### ### # ### # # # ### ### ### ##### # ### # # # ##### #
#   #   #   # #   # # # #   #   # #   # #   #     #       #   # #   #   #   #   #
# ### ############# # # ### # ### # # # ##### ### ### ##### ### # # ####### # ###
#   # # #       #   # #     #   # # #   #     # # #   #     #     # #   #   #   #
##### # # # ### ### ####### ### # ### # ### ### # # ### ######### ### # # # #####
#   # #   # #   #   #   #     # # # # #   # # #   #   #   # #   # #   # # # #   #
# # # # # # # ### ### ##### ### # # # ##### # # ##### # # # # ##### ### # # # # #
# # # # # # # #   #   #   #     #   #     #   #   # # # #   # # #   # # # #   # #
# # # ### # # # ### ### ################# ####### # # ##### # # # ### # # # ### #
# #   #   # #   #   # #         #       # #     # #     #   #     # #     #   # #
# # ### ### # ### # # ### ##### # ##### # # # # # # # ### ### ##### ####### # # #
# # #   #   # #   # #   # #       #   # # # # # # # #   #   #         #     # # #
# ### ### ### # # ##### ##### ##### # # # # # # # ### ##### ######### # ##### ###
#     # #   # # #   # #   # #       # # # # # #   #   # #     #       # # #     #
# ##### ### ##### ### ### # ####### # ### # ####### ### # ### ######### # # #####
#   #     #         #   #   #   # # #   #     # #   #   #   #   #     # #       #
### # ### ############# ### # # # # ### ### # # ##### ##### # # # # # # ####### #
#     #                   #   #       #     #               # #   # #     #     #
############################################################### #################

