############################################################################# ###
#   # # #         #       #         #         #     #     #   #           # #   #
# ### # # ### ########### # ### ##### # ### ##### ### # ### # ### # ##### # # # #
# #       #       #     #     # #     #   #     #     # #   #   # # #   # #   # #
# # ######### ### # # ######### # ####### # ### ##### # # ##### # # # # ### ### #
# #     #   # #   # #           # #     # # #   #   # # #     # # #   #       # #
# ##### ### ### ### ############# ##### # # # ### ##### ### ### ##### ####### # #
#     # #     #       #   #   #   # # #   # # #   #   # #   #   #   #   #     # #
# ### # # ########### # # ### # # # # ####### # ### # # # ### # # # ### ####### #
#   # #   #       #     #     # # # #     #   # #   # #     # # # # #   #     # #
### # # ### ### # # ##### # ### ### # ##### ### ### # ####### ### # # ##### # # #
#   #   #   #   #   #     # # #   # #       #     # #       #     # # #     #   #
# ####### ##### ### ### ##### ### # # ########### # ####### # ##### ### ####### #
#   #     #   # #   # #   #       #   #         # #   # #   #   #   #   #   #   #
##### ####### ####### # # # ##### ##### # ####### ### # # ####### ### # ### # ###
#       # # # # #   # # #   # #   #     #         #     # #     # #   #     #   #
# ####### # # # # ### # # ### # ### ############# ### ### ### # # # ### ##### ###
#       #   # # #     # # # # # #   #           #   # #   #   # #     #     # # #
# ### # ### # # # ### ### # # # # ### # ######### # ##### # ### ####### ### ### #
# #   #     # #   # # #     # # #   # #   #     # #     #     #         # #     #
########### # ##### # # ##### # ### ##### # ### ####### ############# ### ### # #
#   #     # #   #   #   # #     # #     # # # #     #   #     #     #   # # # # #
# # ##### # ### # # ##### # ##### ##### # # # ##### # ### ### ### # ### # # ### #
# #     # #     # #       # #           # # #   #     #     #   # # #       #   #
# ### # # ######### ##### # ### ####### # # # # # ##### ##### ### # ######### ###
# #   #       #   # #     #   #   #   #   # # #     #   #   # #   #   #     #   #
# # ########### # # # ##### # ####### ##### # ##### # # ### # # ##### # ### ### #
# #             #   # #   # #       #     # # #   # # # #   #   #   # # # #     #
# # ################# # # ####### # # ### # ### # # ### # # ####### # # # # #####
# #     #           # # # #   #   # # #   #     # # #   # #     #   #   # # #   #
# ##### # ######### # ### # ##### # # # ######### # # ### ##### # ####### # # # #
# #   #           # #         #   #   #           # #   # #   # # #           # #
# ### ##### ### # # ######### ### ##### ##### ##### ### # # # # # # #############
# #     #   #   # # #   #   # #   #   # # #   # #   #   # # #   # # #       # # #
# # ### # # ##### # # # ### # ### # ##### # ### # ### ### ##### # # # # # ### # #
# #   # # #   #   # # # #   # #   # #     #   # #     #       #   # # # # #     #
# ### ####### ### # # # # ### ### # # ### ### # ### ##### ### # ### # # ##### # #
# #         # # # # # # #     #     # #       # #   #     #   # #   # #       # #
# ####### ### # # ### # ##### ######### ##### # # ### ##### ##### ##### # ##### #
# #       # # # # #   #     # #   #   #   #   #   #   #     #     #   # #   #   #
# # ####### # # # ### ##### ### # # # ### # ### ### ######### ##### # ##### # ###
# # #   # #   # #     #   #   # #   # #   # #   #     #     #   #   #   # # #   #
# # # ### ##### ####### ### # # ##### # ####### ##### ### ##### # ##### # ##### #
#   # #               #   # #       #   #   # #     #   #     # #     # #   #   #
##### # ####### # ##### # ######### ### ### # ##### ### ##### # ####### # # # ###
#   #       #   # #     #           #   #   # # # #   # #     # #     # # #     #
# ### ####### ##### ############# ####### ### # # ### # # ### # # ### # # ### ###
#     # #   # #   # # #         #       # #   # #   #   #   # # # #   # #   #   #
# ##### # # # # # # # ##### # # ### # ### # # # # # ####### ### # ### # ### # # #
# #   #   # # # # # #     # # #   # # #     #   # # #   # # #     #   # #   # # #
# # # ##### # # # # ### # ### ### ### ##### ##### ### # # # # ##### ### # ##### #
#   #       #   #       #     #     # #   #   # #     #   #   #     #   # #   # #
######### # ### ### ########### # # # # # # ### # ####### # ##### ### ### # ### #
#         # #     # #           # # #   #   #           #       #         #     #
############################################################# ###################

