##################################################### ###########################
# #   #       #           # #     #     #         #           #       # #       #
# # # ### ### # # ####### # # ##### ##### # ##### ##### ### ### ### # # # ##### #
# # #   #   #   # #     #     #   #       # #   #   #   # #   #   # #   # #     #
# # ### ### ##### # ### ####### # ######### # # # # # ### # # ### # ### ### ### #
# #   # #   #   # #   #         #   #       # # # # #   # # #     #   #   # #   #
# ### # # # # ### ### # ########### # ####### # ####### # # # ########### # #####
# #   #   # # #   #   # #   #     # #   #   # #         # # # #     #     #     #
# # # ####### # ### # # # # ### # # ### # ### ### ####### # ### ### # ######### #
# # # #   #   # # # # # # #     # #     #     # # #     #   #   #   #         # #
# ### # # # # # # # # # # ####### ############# # # ### ##### ### ########### # #
#   # # #   # # # # # #   #     #   #           # #   #   #   # #     #     # # #
### # # # # ### # # # ### # ####### # ######### # ### ### # ### # ### # ### # # #
#   # # # #   # #   # #   #   #   #     #     #   #   #   #     #   #   # # #   #
# ### # ##### # # ##### ##### # # ####### ### ##### ### ### ####### ##### # # ###
# #   #     #   #   #   # #   # #   #   #   # #       #   #   #   # #   #   #   #
# ### ##### ####### # # # # ### ### # # # # ### ##### ####### # # ### ### ##### #
# #   #         #   # #   #   # # # # #   #         #         # #   # #   #   # #
# # ### ######### ### ####### # # # # ####################### # ### # # ### # # #
# # #   #       # #   #   #   #   #   #     #   #         #   #   # # #     #   #
# # # ### ##### # # ##### # ##### ##### ### # # # ####### # ##### # # ##### # ###
#   # #   #   #   #   #   #     # #   #   # # # #       # # #   # #   #   # # # #
# # ### ##### ####### # ##### # # # # ### # ### ##### ### # # # # # ##### ### # #
# #   # #     #   #   #     # #   # #     #     #     #   # # #   # #     #   # #
##### # # ##### # # ### ### # ##### ############# ##### ### # ### ### ##### ### #
#   #   #       #   #   #   #   # #           #   # #       #   #   #   #   #   #
# # ############# ### ### ##### # ##### ##### ### # # ########### # ### # ### ###
# # #   #         #   # # #     #   #   #   #     #   #         # #   # #     # #
# # # ### ####### # ### # # ##### # ##### # ########### ####### # ### # ####### #
# #   #     #     #     # #   #   #       #   #         #     # # #   #         #
# ##### ##### ######### ##### # # ########### # ####### ##### # ### ########### #
# #   # #       #     # #     # # #         # #   # #   #   # #   # #     #     #
# # # # # ####### ### # # ### # ### ####### # # # # # ### # # ### # # ### # ### #
# # #   #   #   # # #   # #   # #   #     # # # #   #   # # #     #   # # #   # #
# # ####### # # # # ### # ##### # # # ##### # # ### ##### # ##### ##### # ### # #
#   #     # # #   #     #     #   # #     # # #   # #   # # #   #       #   # # #
# ####### # # ##### ######### ##### ##### # # ### # # # # # ### ##### # ### # ###
#       #   #   #   #       # #   #     #   #   # #   # # #     #   # #     #   #
####### ##### # # ### ####### # # ##### ##### ### ##### # # ##### # ########### #
#     #   #   # #   # #   #   # # #     #   #   # #       #     # #   #         #
# ### ### # ### ### # # # # ##### # ### ### ### # ############# # ### # #########
#   #     #   #   #   # # # #       # # #     # #   #     #   # # #     #   #   #
### ############# ##### # # # ####### # # # ### ### # ### # ### # # ####### # # #
#   #     #     #   #   # # #   #     # # # #     #   #   #       # #   #   # # #
# ##### # # # ##### # # # # ### ##### # # ### ### ##### ############# # # ### # #
# #   # # # #     # # # # #     #   #   # #   # #     #     #         # #   # # #
# # # # # # ##### # # # # ####### # ##### # ### ##### # ### # ######### ### # # #
#   # # #   #       # # # # #     #   #     # #       # # #   #         #   # # #
### # ### ### ##### # ### # # ##### # ####### ######### # # ### ######### # ### #
# # #   #   # #     #   #   #   # # #   #   #   # #   # # # # #           #     #
# # ### ### ### ####### ### ### # # ### # # # # # # # # # # # ##### ########### #
# #   #     #   #     # # #     #   # # # # # # # # #   # # #     #       #   # #
# ### ####### ### # ### # # # ####### # # # # # # # ##### # # ### ######### # # #
#     #           #     #   #         #   #   #     #       #   #           #   #
############################################################### #################

