########################################################### #####################
# # #       # #           #   #       #     # #       # #             #   # #   #
# # ### ### # # # ######### # # ##### # # # # # ### # # # ########### # # # # # #
# #   #   #   # #   #   #   #   #     # # #     #   # #   #         #   # #   # #
# # # ##### # # ### # # # ### ####### ### ####### ### ### # ############# ##### #
# # # #   # #   #   # # #   # #     # #   #       #   #   #     #       #     # #
# # # # # ### ### ### # ### ### ### # # ### ####### ### ####### # ##### ##### # #
# # #   #     #   #   #   #   #   # # # # #       #     #     #     #     #   # #
# # ########### ### ##### ### # ### # # # ##### ### ##### ### ##### # ##### ### #
#   #   # #     #   #   #   # #   # #     #   #   # #   #   #     # #     # #   #
####### # # ### # ### # ##### # # ######### # ### # ### ### # ### ####### # # ###
#     #       # # #   #   #   # #   #       # #   #   #     # # #   #   #   #   #
# ### ######### # # ##### # ### ### # ####### # ##### ####### # # # # # ##### # #
#   #   #   #   #       #   # # #   #   #     # #             #   # # #     # # #
### ### # # # ######### ##### # # ##### # ##### ################### ### ### # # #
# #   #   # # # #   #   #   #   # #     #   #       #   # #       #     #   # # #
# # # ##### # # # # # ### # # ### ##### ##### ##### # # # # ##### ####### ### # #
# # #     #     # # #   # #   #   #   # #     #       #   #   #   #       # # # #
# ### ### ####### # ### # ##### ### # # # ################### # ### ### # # # # #
#     # # #   #   #   # #   # #     # #   #       #   # #   # #     #   # # # # #
####### # # # # ##### # ### # # ##### ### # ##### # # # # # # ####### ### # # # #
#     # #   #   # #   #   # # # # #   #   # #   # # # #   #         #   #   # # #
# ### # ######### # # # # # # # # # ####### # # # # # ############# ####### ### #
# # #   #     #   # #   # # # # #   #       # # #   # #     #   #   #     #     #
# # ##### ### # # # ##### # # # # ####### ##### ##### # ### # # # ### ### #######
#       # #     # #     #   #   #     # #     #     # #   #   #   # #   # #     #
# ##### ### ##### ################### # ##### ##### # ### ####### # ### # # # ###
# #   # #     # #     #   #         #         #     #   # #   #     #   # # #   #
### # # # ### # ##### # # # ### ############# # ##### # ### # ######### # ##### #
#   # #   #     #   # # #   #   #     #     # #     # #     # #       # # #     #
# ### # ######### # # # ##### # # ### # ### ####### # ####### # ##### # # # #####
# #   #           # #   #   # # #   # # #   #     # #       # #     #   # # #   #
### ############### # ### # # ##### # # # ### ### # ####### # ##### ##### # # ###
#   #             # # #   # #   #   #   # #   #   #     #   # #   #   #   # #   #
# ### # ### # ##### ### ### ### # ####### # ### ####### # ### # # ### # ### # # #
# #   #   # #       #   #   #   #       #   #   #   #   #   #   #     # # #   # #
# # ### ### ######### ### # # ######### ### # ##### # # ############### # # ### #
#   # # #   #       # #   # #     #   #   # #       # #     #   #     #   #   # #
##### # # ### ### ### # # ####### # # # # # ####### ####### # ### ##### ##### # #
#       #   #   # #   # # #   # #   #   # #       #         #   # #     #     # #
# ########### # # # ### ### # # # ######### ####### ######### # # # # ### ##### #
#   #       # # # # #     # #   # #       # #     # #   #   # #   # # #   #   # #
### # ##### ### # # ##### ### ### ### ### # # # # # # # # # ##### # ### ### ### #
#   # #   # #   # #   # # #   # #     #   # # # # # # #   #       #   # #   #   #
### # ### # # # ##### # # # # # # ##### ### # ### ### # ##### ####### # # ### ###
#   #   #   # # #   #   #   # # #   # # #   # #   #   # #   # #     # # #       #
# ##### # ##### # # ### ##### # ### # # # # # # ### ### # # ### # ### # #########
# #     # #     # # #   #     # #   # # # #   #   #   #   #     # #   # #   #   #
# ### ### # ### ### # ####### # # ### # # ######### # ########### # ### # # # # #
#     #   # # #     # # #   # #   # #   # #     #   # #     # #   #     # # # # #
####### ### # # ### # # # # # ### # ##### # ### # ### # ### # # ##### # ### # # #
# #   #     #   #   # #   # # #   # #     # # #   # #     # # #     # #   #   # #
# # # ### ####### ### ##### ### # # # # ### # ##### ##### # # ##### ### # ##### #
#   #     #           #         # #   #     #             #   #         #       #
# ###############################################################################

