############################# ###################################################
# #     # #         #               #         #     # #   #           #   #     #
# # ### # # # ##### # ####### ##### ####### ### ### # # # # # ### ### # # ##### #
# #   # # # #     # # #   #   #   #   #   #   #   # # # #   #   # #   # # #     #
# # # # # # ##### # # # # # ### ### # # # ### ### # # # ####### # # ### # # #####
#   # # #   #     #   # #     #     # # # # #     # # # #       # # #   #   #   #
### ### # ### ############### ####### # # # ### # # # # # ######### # ####### # #
# # #   #   #     #         # #     # # #   #   # # #   #   #     # #   #     # #
# # # ##### ##### # ### ### # # ### # # ### ##### # ####### ### # # ### ####### #
#   #       # #   #   # #   #     # # #   #       #     # #     # #   #       # #
############# # ### # ### ######### # # ############### # # ####### # ####### # #
#   #     #     #   #   #   #       #   #   #         # # # #   #   #         # #
# # # # ### ##### ##### ##### ### ####### ### # ##### # # # # # # ############# #
# #   #     #   #     #     #   # #   #       #     # #     # # # #       #   # #
############# # ### # ##### ### ### ##### ######### ######### # # ####### # # # #
#         #   #     #     #   #     #   # #       # #         # #   #     # # # #
# ### ##### ########### # ### ####### # ### # ### # # ######### ### # ##### # # #
# # #   #   #     #   # #   #   #   # # #   # #   # # #     # #     #   # # #   #
# # ### # # ##### # # ##### ### # # # # # ##### ### # # # # # # ####### # # # ###
#   #   # #   #   # # #       # # # # #   #     #   #   # # # # #   #     # #   #
# ### ### ### # ### # # ####### # ### ##### ####### # ### # # # ### # ##### ### #
#   # #   # # # #   # #   #     #   #   #   #       # #   # # #     # #   #   # #
### # # # # # # # # ##### # ####### ### # ### ####### # ### # ### ### # # ### # #
#   # # # # #   # #     # # #       #   #   #   #     # #     #   #   # #     # #
# ### ### # ##### ##### # # # ####### ### # ### ####### # ##### ### # ### ##### #
#   #   #   #     # #   # #   # #   #   # #     #       #     #   # # #   #   # #
### ### ##### ##### # ### # ### # # ### # ####### ########### ##### # # ### # # #
# #   #     # #   # #     #       #   # # #     #   #       #       #   #   # # #
# ### ### # # # # # ################# # ### ### ### # ##### ############# ### # #
#   #   # #   # #       #   #       #     #   #   # #   #   #   #   #   #   #   #
# # ### # ############# # # # ########### ### # # # ##### # ### # ### # # #######
# #     # #         # #   # #             # # # # #       #   #       # # #     #
# ####### ### ##### # ##### # ########### # # # # ########### ######### # # ### #
# #     # #       #   #       #   #       #   # # #       #   #       #   # #   #
# # ### # # ######### # ####### # ############# # # ##### # ### ##### ##### # ###
#   #   #   #     # # #   #   # #   #       #   #   # #   # # #     #     # #   #
############# ### # # # # # # # ### # ##### ####### # # # # # ##### ##### # ### #
#   #     #   #   #   # #   # # # # # #     #       #   #   #   #   #   # #   # #
# # # ### # ### # ######### # # # # # # ##### ####### ####### # ####### # ##### #
# # # #   # #   # #       # # #   # # #   #     #     #   #   #         #     # #
# ### # ### # ### # ##### ### # # ### ##### # # ##### # ### ### ####### ### # # #
# #   #     # #   # #   # #   # #   #       # #     # #     #   #       #   #   #
# # ##### ### ##### # # # # ### ### ######### ##### ######### ### ####### #######
# # #   #   #   # #   # #     #   #   #       #   # #       #   # #     #       #
# # # # ### ### # ### ######### # ### ##### ### # # # ##### ### # # ### ####### #
#   # # #   # #   #   #         # #   #   #     # #   #   #     # #   #     #   #
# # # # # ### # ### ### ######### ### # # ####### ##### ######### ### ### # # ###
# #   # # #   #   #   # # #     #   #   # #     #   #   #   # #     # #   # #   #
####### # # ##### ### # # # # ### # ##### # ####### # # # # # # ##### # # ##### #
#   #   # # #   # #   #     # #   #   #   # #     # # # # # #   #     # #       #
# # # ### # # ### # ######### # ##### # ### # # # ### # # # # ### ##### #########
# #   # # # #   #   #         # #   # #       # # #   #   # # # #     # #   #   #
# ### # # # # # ##### ######### # # ############# # ##### ### # # # ### # # # # #
# # #   # # # #   # # # #   #     #     #   #     # #     #   #   # #   # # # # #
# # ##### # ### # # # # # # # ######### # # # ##### # ##### ####### # ### # ### #
#       #       #     #   #   #           # #       #               #     #     #
######################### #######################################################

