########################################################### #####################
#   #     #   #   #             # #       #   #       #   #               # #   #
# # ### # # # ### # ##### ##### # # ### ### # # ### # ### # ### ####### # # # # #
# # #   #   #   #   #     #     #   # #   # #     # #     #   # #     # #   # # #
# ### ######### ##### ##### ####### # ### # ##### ########### # # ### ### # # # #
#     #       #     #   #   #     # #     #     #             # # #   #   #   # #
# # ######### ##### ### ##### # # # ##### ####################### # ### #########
# # #   #       #       #   # # # # #     #   #       #         # # #   #       #
### # # # ####### ####### # # # # # # ##### # # ##### # ####### # ### # # ##### #
#   # #   #       #   # # #   # #   # #     #   #   # #       #       # # #     #
# ### ##### ### ##### # # ##### ##### # ##### ### ### ##### ########### ### # ###
# #   #   #   # #   #     #         #     # # #   #     # #         #       # # #
# # ### # ### # # # ############### ##### # # # ### ### # ######### ######### # #
# # #   #   # # # # #         #   #     # # # #     # #   #   #   #         # # #
# # # ### # # ### # # ####### # # ##### # # # ##### # ### ### ### ####### # # # #
# #   # # #   #   # # #     # # #     # # #   #   #   # #   # #   #     # # # # #
# ##### # ##### ### # # ### # # ##### # # ##### # ### # ### # # # # # ### # # # #
#   #   # #     # #   # # # #     # # # # #     # # # # #   #   #   #   # # #   #
### # ### # ##### # ### # # ##### # # # # ### # # # # # # # ########### # # #####
# # #   # #     #   #   # #       # # # #     # #   # # # #     #     #   #   # #
# # # # ##### # # ### ### ######### # ##### # # ##### # # ##### ##### # ##### # #
# #   # #     # #   #   # #         #       # #     # # #     #       # #   #   #
# ##### # ##### ####### # ######### ############### # # ##### ########### # ### #
#     # #     #   #   # #   #     #     #   #   #   #   #   # #   #       #     #
# ### # ##### ### # # # ### # ### ##### # # # # # ####### # # # # # #############
#   #     # # #     # #     #   #       # #   # #       # #   # #   #   #       #
######### # # ################# # ####### ##### ####### # ##### ##### # # ##### #
#       # # #   #         #     # #           #         # #       #   # #     # #
# ##### # # ### # ### ##### ##### # ############### ##### ####### # ######### # #
# # #   # #     #   #       # #   #     #       #   #   #         #       # # # #
# # # ### # ####### ####### # # ##### ### ##### # ### # ############### # # # ###
# # #   #       #   # #     # #       #   # #   #     #                 # #     #
# # # ######### ### # # ##### ######### ### # # ######################### ##### #
#   # #     #   #   # #     # #         #     # #           #         #   #     #
##### # ### # ### ### ### ### # # ############# ######### # ####### # # ### #####
#       # # #   #       # #   # #   #     #   # #     #   #       # # # #   #   #
# ####### # ### # ##### ### ### ### # ### # # # # ### # ######### # # # # ### ###
# #     #   #   # # #   #   # # # #     #   # # #   # # #     # #   # # #       #
# # ### ##### ### # # ### ### # # # ##### ### # ### # # # ### # ####### # ##### #
#   # #   #   #   # #     #   # # #     # #   #     #   # #         #   # #   # #
### # ### # ### ### ####### ### # ##### # ################# ####### # ### # # # #
#   #   # # #       #     # #   #   #   #     #   #         #   #   # #   # #   #
# ##### # # ######### ### # # ##### # ####### # # # ######### # ### # ##### # ###
#   #   # # #     #   # # #   #     #     #   # # #       #   #   # #     # # # #
### # ### # # ### # ### # # ### ######### # ##### # ##### # ##### ####### # # # #
#   # #   # #   #   #     # #   #         # #     # #   #   #   #       # # # # #
##### # ### ### ##### ##### # ### ######### # ##### # # ### # ##### # # # # # # #
#       #   # # #   #   #   #     #     #   # #       # #   #     # # # # # # # #
# ####### ### # # # ##### # ##### # ### # ### ######### ######### # # # # # # # #
# #   #       # # #     # # #     #   #     #       # #         # # # # # # #   #
# # # ####### # # ##### # # ################# ##### # # ##### # # # ### # # ### #
# # #       #   #     #   #     #             #   #     # #   #   #   # # # #   #
# # ####### ######### ####### # # ######### ### ######### # ######### # # # #####
#   #   #   #       # #     # # #       #   #           # #     #   # # #       #
##### ### ### ### # # # ##### # ####### # ############# # ### # ### # ######### #
#             #   #   #       #         #               #     #     #           #
############################################################################### #

