####################################### #########################################
# #         #   #                         #     #       #     #         #       #
# # ### ### # ### ################# ##### ### ### ##### # # ### # ####### ##### #
#     #   #   #       #         # #     #   # #   # #   # # #   #     #   #   # #
### # ### ##### ####### ####### # ##### ### # # # # # ### # # ####### # ### # # #
#   # #   #   #   #     #     # #     # # #   # #   # #   #   #     # # #   #   #
##### # ### # ### # ##### ### # # ### # # ### ####### # # ####### # # # # #######
#   # #     #   # #     # #   #   # # #   #   #     #   #       # # #   # #   # #
# # # ####### ### # ##### ##### ### # # ### ### ### ########### ### # ### # # # #
# # # #     #     # #     #     #   # #   #     # #   #       #     # #   # #   #
# # # # ### ####### # ##### ##### ### ### ####### # # # ##### ######### ### ### #
# #   #   #   #   # #     #     #     # # #       # #   # #           #     #   #
# ####### # # # ### ##### ### ### ##### # # # ##### ##### # ######### ### ### ###
# #       # # #   # #   # # #   #   # #   # # #   # #     #   #       # #   # # #
# # ####### # # # # # # # # ### ### # # ### # # # # # ####### # ### ### ### # # #
# # # #     # # # #   # #   #   # #   #     # # #   # # #     #   # #     # #   #
# # # # ##### ### ##### # # # ### ########### # ### # # # # # ### ### ##### #####
#   #   #   #       #   # # #     #         # #   # # #   # # #   #   #     #   #
######### # ######### ### # # ##### ##### # ##### # # ####### # ### ### ##### # #
#         # # #   #     # # # #     #   # #       # #         #   #     #     # #
# ######### # # # # ### # # ### ##### # # ##### ################# ##### ##### ###
# #   #     #   #   #   # # #   #   # # #     # #       #           # # #   #   #
# # # # ##### ### ### # ### # # # # ### ##### ### ##### ########### # # # # ### #
#   # # # #   # #   # #   # # #   #     #   # #   #   #   #   #   #   # # # #   #
# ### # # # # # ### # ### # # ######### ### # # ### ### # # # # # ### # # # # # #
# #   #   # #   # # #   #   #   #     #     # # #     # #   #   #   # # # # # # #
# # ##### # ##### # ### ####### # ### ####### # # ### # ############# # # # ### #
# #     # #       #   #     # #   # #   #     # # # #       #       # #   #   # #
####### # # ######### ##### # # ### ### # # ### # # ##### # # ##### ####### # # #
#   #   # # #             # # # #       # # #   #     #   # #   # #     #   #   #
# # # ### ### ############# # # ####### # ### ####### ##### ### # ##### # #######
# #   #   #   #     #       # #       # #     #     # #   #     #     #   #     #
# ##### ### ### ### # ####### ####### # ##### # ##### # # ########### # ### ### #
#     #   #   # # #           #     # # #   #   #     # # #   #   #   # #   #   #
##### ### # # # # ############# ### # # # # ##### ##### # # # # # # ##### ### ###
#   #   #   # # #     #   #   #   # # # # # #   # #     #   #   # #       # #   #
# ##### ####### # ### # # # # # # ### # # # # ### ########### ### # ##### # ### #
# #   # #     #   #   # #   # # #     # # #     #     #     #   # # #     #     #
# # # # # ### # ##### # ####### ####### # ##### ##### # ### ##### # # ###########
#   #   #   #   #   # #   #     #     # #     #     #   #   #   # # #   #   #   #
########### ##### # # ### # ####### # # ######### # ##### ### # # # # ### # # # #
#           #   # # # #     # #     # # #   #     # #   # #   #     # #   # # # #
# ########### # # # ### ##### # ##### # # # # # ### ### # # ####### ### # ### # #
# #       #   # # #   # #     # # #   #   #   #   # #   # # #     # #   # #   # #
# # ##### # ### # ### # # ### # # # ### ########### # ### # # ##### # ### # ### #
# #   #     # # # #   #   # #   #   # #   #         #   # # #       # #     #   #
# ### # ### # # ### ##### # ##### ### ### # ########### # # # ##### ### ##### ###
# #   # #   #   #   #   # #       #   #   #         #   #   # #   #   #     # # #
# # ### # ####### ### # # # ####### ### ########### # ######### # ### ##### # # #
#   # # # #   #   #   #   # #       #   #     #   #   #       # #   #   #   # # #
##### # # # # # ### ####### # ####### ##### # # # ##### ##### # ####### # ### # #
#   # # #   #   #   #       # #     #       # # # #   # #   #   #   # #   #   # #
# # # # ######### # # ####### # ### ######### # # # # # # # # ### # # ##### # # #
# # # # #     #   # # #     # # #     #       # #   # # # #   #   #   #     #   #
# # # # # ### # ##### # ### # # # ##### # ### # ##### ### ##### ####### #########
# #       #     #       #   #   #       #   #   #             #                 #
####################################################### #########################

