################# ###############################################################
#     #   #     #         #                       #     #               #     # #
# # ### # ### # ##### ### # ##################### # ### # ############# # ### # #
# # #   #     #     # #   # #     #     #     #   # # # #           #   # #     #
# # # ##### ####### ### # # # ##### # ### ### # # # # # # ########### ### # #####
# # #     # #   # #     # # # #   # #     # # # # # #   #     #     #   # #     #
# ####### # # # # ### ### # # # # # ##### # # # # # ######### # ### ### # ##### #
#   #   # #   #     # #   #     # #     # # # # # #     #   # #   # #   #   #   #
### # ### ######### # # ######### ##### # # # # # ##### ### # # # ### # ### ### #
#   # #   #       # # # #       #       # #   # #     #   #   # # #   #   #   # #
# ### # ### ##### # # ### # ##### ####### # # ####### ### ### ### # ##### ### ###
#       #       #   #     #     # #     # # #       #   #     #   # #     # #   #
############### ############### ### # # # ######### ### ####### # # ### ### ### #
# #   #       #     #         #     # # #         # # #     #   # #   #   #     #
# # # # # ### ##### # ####### ####### # ####### ### # # ### # ##### # ### # ### #
#   # # #   # #   #   #     #     # # # #   #   #   # #   #         # #   # # # #
##### # ### # # # ##### # ####### # # ### ### # # ### ### ############# ### # # #
#   #   # # # # #     # #       #   #     #   # #   # # # #           #     # # #
# # ##### # # # # ### # ####### ### ####### ##### # # # # ### # ##### ####### # #
# #   # #   #   #   # #   #   #     #       # #   # # # #     #     # #     #   #
# ### # ########### ### ### # ##### ### # ### # ### # # ########### # ##### # ###
#   # #   #   # #   #   #   #     #   # #     #   # # #       #   # # #     #   #
### # # # # # # # ### ### ####### ### # ### ##### ### # ##### # # ### # ####### #
#   # # #   #     #   # # #       #     #   #   #     #   # # # #     # #     # #
# ### ########### ### # # ############### ### # ######### # # # # ##### # ### # #
#   #           # #   # #   #         #     # #         #   #   # #   #   # #   #
# # ####### ### # # ### ### # ######### ##### ######### ########### # # ### # ###
# # #     #   # #   #     #         #   #   #   #   #   #   #       # # #   #   #
# # ### ##### ####### ############# # ### # ### # # # ### # # ##### ### # ##### #
# #   # #     #   #   #   #         #   # #     # # # #   #   #     #   # #   # #
# ### # # ##### # # ### # # ########### # # ####### # # ####### ##### ### # # # #
#   #   # #   # # #     # # #     #     # # #     # #   #   # # #   #     # #   #
##### # # ### # # ### ### # # ##### ##### # # # # # ##### # # # # # ##### # #####
#   # # # #     # # #   #   #       #   # # # # # #     # # # #   #   #   # #   #
# # # # # # ##### # # # ############# # # ### # # ##### # # # ####### # ### # # #
# #   # #     # #   # #   #     #     # #     # #     # # #   #   #   #   #   # #
# ########### # ### ### ### ### # ### # ############# # # ##### ### ### # ##### #
# #     # #   #   #   #   #   # #   # #           #   #   # #       #   # #   # #
# # ### # # ##### # # ### ### # ### ### ######### # ### ### # ####### ### # ### #
# # #   # #     #   #   #   # #   #   # #     #   # #       #         # # #     #
# # # ### ##### ######### # # ### ### # # ### ##### ### ############# # # # ### #
#   # #         #         # # #   #   # # # #       #   #   #     #   #   # # # #
# ##### ####### # ######### # # ####### # # ######### ### # # ### # ####### # # #
# #   #     #   #   #     #   #       #   #   #       #   # # #     #   # # # # #
### # ##### # ##### # ### ########### ##### # ##### ### ### # # ####### # # # # #
#   # #     # #   #     #   # #       #     # #   #     # # # #         # # # # #
# ### # ##### ### ##### ### # # ##### ##### # # # ####### # # ########### # # # #
#   # # #     #   #   # #   #   #   #       # # #         # # #       #     # # #
# # # # ####### ### # # # ####### # ######### # ######### # ### # ##### # ### # #
# # # # #       #   # # #         # # #     #     #     #       #     # #   # # #
# # # # # ### ### ### ### ######### # # # ######### ### ############# # ##### # #
# # #   #   # #   # # #   #       #   # #           # #       # #     #     #   #
### ####### # # # # # # ### ##### # ### ### ######### # ##### # # ####### # #####
#   #   # # #   # # # #   # #   # #     #   #   #   #   #   # #   #   #   # #   #
# ### # # # ##### # # ### # ### # # ######### # # ### ### ### # ### # # # # # # #
#     #         #   #     #     #   #         #       #       #     #   # #   # #
##################################### ###########################################

