############################################################### #################
#   #   #     #           #       #       # #                     #   #     #   #
# # # # # ##### ##### # # ### ### ####### # # ################# ### # # ### # # #
# #   #   #   #     # # #     # #     #   #   #     #   #     # #   #   # #   # #
# ####### # # ##### ### # ### # ##### # ### # # ### # # # ### ### ####### # ### #
# #     # # #       #   # #   # #     #     # # #   # # # #       #         #   #
# # ### ### ####### # ### # ### ##### ####### # # ### # # ######### ######### ###
# # #   #   # #   # # #   #     #   # #   #   # # # # #         #   #   # #   # #
# # # ### ### # # # # # ######### # # # # # # # # # # ######### ##### # # # ### #
#   #   #     # #   # # #     #   #   # # # # # #   #   #     #     # #   #   # #
# ##### ##### ####### # # ##### ####### # ### # # ####### # # ### ### # ##### # #
#     #       #       #   #   #     #   #   # # #       # # #     #   #     #   #
############### ########### # ##### # ##### # # ####### # # ####### ##### # #####
# #   #   #   # #         # # # #   #     #   #   #     # # #       #     # #   #
# # # # # # # # ####### # # # # # ### ##### # ### ### ### # # ####### ##### ### #
# # # # #   # # #       #   # # #   #   #   #   #   #     # #   #   # #   #     #
# # # # ##### # # ########### # ### ### # ######### ####### ### # # # # # ##### #
#   # #   #   # # #         # #   #   # #   #     # # #   #     # #   # # #   # #
# ### ### # ### # # ####### # ### ### # ### # # # # # # # # ##### ##### # # # ###
#   #   # # #   # #   #   # # #   #   #   #   # # # #   #   #     #     # # #   #
### ### # # # ### ### ### # # # ### ####### ### # # ######### ####### ### # ### #
#   # #   # #   #     #   # # #     #     # #   # # #       # #     # #   #   # #
# # # # ####### # ##### # # ### ##### ### # ##### # # ##### ### # # # # # ### # #
# # # #       # #   #   #   #   #     #   #   #   # #     #     # #   # #     # #
# ### ####### # ### # ####### ### ##### ##### # ### ####### # ##### #############
#       #     #     #   #   #   # #   #       #   # #       # #   # #   #       #
### ### ### ######### ### # ### # # ##### ####### # # ######### # # # # # ##### #
# #   #   # # #   #   #   # #   #   #     #     #   # #       # #   # # #   #   #
# ### ### # # # ### ### # # # ### # # ##### ### ##### # ##### # ### # # ### # ###
# # # #   #   #   # #   # #   #   # #     # # #       #     # #   #   #   # #   #
# # # ##### # ### # # ### ##### ######### # # # ######### # ##### ####### ##### #
#     #   # #     # #   #     #     #   # # #   #   # #   #       #     #     # #
####### # ### ##### # # ######### # # # # # ##### # # # ########### ##### ### # #
# #     #   #     # # #           # # # # #   #   #     #   #     #     #   #   #
# # ####### ##### # # ########### # ### # # # ####### ##### ##### ##### ### #####
# #   #   #       # # #       #   #     # # # # #   # #       #   #     #   #   #
# ### # # ######### ### ##### # ### ##### # # # # ### # ##### # ### # # # ##### #
# #   # # #       #     #   # #   # #   #   #   #     #     # #     # # # #     #
# # # # # ####### ##### # ### ### # # # ################### ### ####### # # #####
#   # # #   #     #     #     #   # # #                   #     #       # # #   #
# ### # ### # ### ### ######### ##### ################### ##### # ####### # # # #
# #   # # #   #   #   #       # #   #         #         #     # # #     # #   # #
# # ### # ##### ### ### ##### # # # ##### # # ####### ####### ### ##### # ### # #
# # # # #     #   #     #     # # #       # #       #   #   #     #     #   # # #
# # # # # ####### # ##### ##### # ######### ####### ### # # ####### ##### # ### #
# #   # #     #   #     #     # # #     #         # #   # #   #   # #     #     #
##### # ##### # ####### ##### # # # # # ########### # ### ### # # # #############
#   # # #     #       #     # #   # # #   #       # # #   #   # # #       #     #
# # # # # ########### ### # ##### ### ### # ##### # # # # # ##### # ##### ### # #
# # # #           #   #   #   #   #   #   #     # #   # # # #       #   #     # #
# # # ######### # ########### # ### ######### # # ### ### # ### ##### ##### #####
# # #   #       #       #     #   #   #     # # #   # #   #     #   #     #     #
# ##### # ############# # ####### ### # ### ### # # # # ######### ##### # ##### #
#         #               #       #     #       # #     #               #       #
######### #######################################################################

