####### #########################################################################
#   #     #     #           #     #       #                   #   #   #         #
### # ### # ### # ########### ### # ##### ### # ########### # # # ### # # ### ###
#     #   # #   # #       #   # #   #   #     #   #   #   # # # # #   # #   #   #
# ####### ### # # ##### ### ### # ### # ######### # # # # # # # # # ### ### ### #
#   #     #   # #     #     # #   #   #   #   #     #   # # #   # #     #     # #
# # ####### ##### ### ##### # ### # ##### # # ########### ####### ############# #
# #     #         # #   #   #     #     # # #   #       #   #   # #       #     #
# ##### # ##### ### # # # ############# # # ### # ####### # # # # ### ### # ### #
#     #   #   #   # # # #     #         # # # # #   #     #   # #     # #   # # #
########### # ### # ### ##### # ######### # # # # # # ######### ####### # ### # #
#   #     # # #   #   # #     # # #       #   # # # #     #   # #     #     # # #
# # # ### # # # ##### # # # ### # # ########### # ### # # # # # # ########### # #
# #   # # # # #       #   # #   # #     #   #   #   # # # # # # #     #       # #
# ### # # # # ############# # ### ##### # # # ##### # # # # # # # ### # ####### #
# #   # #   #   #   #   #   #   #       # #   #   # # # # # #   # #   # #       #
# # ### ####### # ### # ####### ####### # ####### # # # # # ####### # # # #######
# #   # #   #   #     #     # #       #   #       #   # # # #     # #   #   #   #
# ##### # # # ########### # # ####### ##### ############# # ### # # ##### # # # #
#       # # #         #   # # #   #     # # #   #     #   #     # #       #   # #
# ### # ### ######### # ### # # # # ### # # # # # # # # ######### ############# #
# #   #     #       # #   # #   #   #   # # # #   # #   # #     #   #   #     # #
# ########### ####### # # # ######### ### # # ####### # # # ### ### # # # ##### #
#           #       #   # #   #     # # #   #       # #   #   # # # # # #   #   #
########### ####### ##### ### # ### # # # ######### ##### ### # # # # # # # # ###
#         # #       #   #   #   # #   # #     #     #   # #   # # # # #   #     #
# ##### # # ####### # ####### ### # ### ### # ####### # # # ### # # #############
# #     # #   #     # #       # #   #       # #       #   #   #   # #     #     #
# ##### # ### # ##### # ####### ##### ####### # ############# ### # # ### # ### #
#   #   #     # #     # #     #       #       #   #       # #   #   # # #   #   #
# # ########### # ##### # ### ######### ######### # ##### # ######### # # # # ###
# #           # #       # #   #       # #       #   #   #             # # # #   #
### ########### ### ### # ##### ### ### # ####### ### # ############### # # #####
#   #   #     #   #   # #   #   # #       #     # #   # #             #   # #   #
# ##### # ### ### ### # ### # ### # # ##### ### # # ##### ##### ######### # # # #
#     # # # #   # #   #   # # #     # #   # #   #   #   # #   #         # # # # #
##### # # # # # # # ##### # # ######### # # # # ##### # # # # ######### # # ### #
#   #   # #   #   #   # # # #     #     #   # # #   # #   # # #   # #   # # #   #
### ### # ########### # # # # ### # ####### ### # # # ### # # # # # # # ### # # #
#     #   #       #   # # #     #   #   # # #   # #   # # # #   #   # #   #   # #
# ######### # ### # ### # ##### ####### # # # ### # ### # # ### ##### ### ##### #
# #       # #   #   #   #       #     # #   #     #     # #   # #     #     #   #
# # ##### # ### ##### ##### ##### ### # ################# ### # # ######### # ###
#   #     # # #       #   # #   #   #   #       #       #   # # #       # # #   #
##### ##### # # ##### ### ### # ### ##### ####### # ### ### # ### ##### # # # ###
#   # #     # # #     #   #   #   # #     #       #   #     #   # # #   #   #   #
# ### # ##### # # ##### ### ####### # ### # ################### # # # # # ##### #
#   #       #   #   # #   # #       #   # #   #   #   #   #   #   #   # #     # #
### ############# # # # # # # ####### ### ### # # # # # # # ####### ##### ### # #
#   #   # #       #   # #   #       # #       # # # # # # # #       #     #   # #
# ### # # # ############# # ##### # ### ### ##### # ### # # # ####### ######### #
#     # #   #           # #     # # #   #   #     #     #   # # #   #   #     # #
##### ### # ########### # ##### # # # ### ### ############# # # # # ### # # # # #
#         #             #     #   #     #                 #   #   #       # #   #
################### #############################################################

