####################################################### #########################
#         #     #     #     #                   # #           #           #     #
######### # ### # ### # ### # ################# # # ######### # ##### ##### ### #
#     #     # #   #   #   # # #           #   # #   #     #   #     #     #   # #
# # ### # ### # ########### # # ######### # # # # ### # ### ####### ##### ##### #
# #     #   # #           #   #     #   #   #     #   #   #         #   # #   # #
########### # ########### # ####### # # ################# ########### # # # # # #
#         # #   #       #     # #   # #   #   #                 #     # # # #   #
# ####### # # # ##### ####### # # ### # # # ### ################# ### ### # ### #
# #       # # # #   # #     #   #     # # #   # #     # #           #   # #   # #
# ########### # # # # # ### ### ######### ### # # # # # # ############# # ### # #
#     #   #   # # #   #   #   #     #   #     #   # # # # #       #   #   # # # #
# ### # # # # ### # ##### ### ##### # # ##### ####### # # ### ### # # ##### # # #
# #   # #   #   # #       #   # #   # #       #     # #   #   #   # #   #     # #
# # ### ####### # ######### ### # # # ######### ### # # ### ####### # ### ##### #
# #   #   #     # # #     #   #   # #   #       # #   #   #   #   # #     #   # #
# ### # # # ### # # # ### ### ##### ### # ####### ### ##### # # # # ####### ### #
#   # # # #   # #   #   #   # #       # #   #     # #     # #   # #   #       # #
### # ### ### # ### ### ##### ######### ##### # # # ### # # ######### # # ### # #
#   # #   # # #     #   #   #     #   #   #   # #   #   # # #   #     # #   #   #
# ### # # # # ####### ### # ##### # # ### # ### ##### ### # # ### ##### ### #####
# # # # # # #     #   #   #   #   # # #     # # #     #   #   #   #   # #       #
# # # # # # # ##### # # ##### ### # # # ##### # # ##### ### ### ### # # ####### #
#   #   #   # #   # # # #   #   #   # #     # #   #   #     #   #   # #   # #   #
############# # # # # # # # ### ##### ##### # ##### ####### # ### # ##### # # # #
#   #       #   # # # #   # # # #   #   #   #       #   #   #   # # #     #   # #
# # # ##### ##### # ##### # # # # # ### # ### ####### # # ##### # # # ##### ### #
# # # #   #   #   #     # #   # # #     # #           #   #     # # #   #   #   #
# # # # ### # # ##### # ##### # ##### ### ################### # ### ### ##### ###
# # # #   # #   # #   #       #     # # #   #   #         #   # #   #   #     # #
### ### # # ##### # ####### ####### # # ### # # # # ####### # ### ### ### ##### #
#       # #   #   # #     # #       #       # #   # #   #   #   # #   #       # #
# # ####### # # ### ##### # # ##################### # # # ##### # # ### ##### # #
# #   #   # # # #   #     # #   #   #     #       #   # #     # #     # #   #   #
# ##### # # # # # ### # ### ##### # # ### # ##### # # # ####### ##### ### # #####
#   #   #   # #   #   #   #       # # # # #     # # # #   #   # #   #     #     #
### # ####### # ### ##### ##### ### # # # ##### # ### ### # # # # # ########### #
#   #   #     # #   #   #       #   #   #   #   #   #   # # #   # # #   #     # #
# ##### # # ##### ### ########### ####### # # ##### ### # # ##### # # # # # ### #
#   #   # #     # # #     #       #     # #   #   #     # #     # # # # # #     #
### # # ####### # # # ### # ####### ### # ##### # # ##### ##### ### # # # # #####
#   # #   # #   # # # # #   #     # #   # # #   # # #   #     #     # # # # #   #
# ### ### # # ### # # # # ### ### # # # # # # ### # # ##### # ##### # ### # # ###
#   # #   #   #   # # # #     #   # # # #   # # #   # #     # # #   #     # #   #
# # ### ### ### ### # # ####### ### # # ##### # # ### # ##### # # # ####### ### #
# #     #   #   #   #   # #     #   # #     #   #   #   #   # # # #   #       # #
# ####### ### ### ##### # # ##### ### ##### ##### ### ### ### # # # # ######### #
# # #   # #     #   #   #   #     #     #   #   #   #   #   # # # # #     #   # #
# # # ### # ##### # # ####### ##### ##### ### # ### ### # # # # # # ##### # # # #
#   #   #   #     # #   #   # #     #     #   #     # # # # #   # # #   # # #   #
### ### ##### ####### # # # # # ##### ##### ######### # # ### # # ### # # # # ###
#   #   #   # #     # #   # # #   #   #     #     # #   #   # # #   # # # # #   #
##### ### # # # ### # # ### # ##### ##### ### ### # # ##### # # # # # # # # #####
#   # #   # #   # #   # #   #     # # #   # #   # #   #     # # # # # #   #     #
# # # # # # ### # ##### # ####### # # # ### ### # # ### # ### # ### # ######### #
# #     # #     #       #         #     #       #   #   #     #     #           #
##################################### ###########################################

