############# ###################################################################
# #         #       #   #     #     #     #     #             #   #     #       #
# # # # ### ####### # # # ### # ### # ### # # # ####### ##### # # # ### # #######
# # # #   # #   #     # #   #     #   #     # #   # #   #     # #   #   #       #
# # ##### # # # # ######### ####### ######### ### # # ### ##### ### ########### #
#   #   # #   #   # #     #   #   # #   #   # #   #     #     #   #   #       # #
##### # # # # ##### # # ##### # # # # # # # # # ### ### ######### ### ### ### # #
#     # # # # #   #   #       # # # # # # #   #   #   #         #   #   # #   # #
# ##### # # # # # # ########### # # # ### ######### # ####### ##### ### # ##### #
#   #     # # # # #   #         #   #     # #       #     # #       # #   #     #
### # ####### # # ### # ################### # ########### # # ### ### # ### ### #
# # # #   #   # #     # #     #   #   #       #         #   #   #   # # #   # # #
# # # # # # ### ####### # ##### # # # # ######### ######### # # ### # # # ### # #
#   # # #     #       # #       # # #   #       #           # # # #   # #   #   #
### # ############### # # ####### # ##### ##### ############# # # # ### ##### ###
#   # #           #   # # #     #     #       # #       #     #   #   #       # #
##### # ####### ### ### # ##### # ### ######### # ##### # ############# ####### #
#     # #   #   #   #   # #   # # # #     #     # # #   #           #   #     # #
# ##### # # # ### ### ### # # # # # ### # # ##### # # ########### ### ### # # # #
#         # # #   # #     # #   #   #   #   #     # #           # #   #   # #   #
########### ### ### ##### # ####### # ####### ##### ##### ####### # ### ### #####
#           #   #       #   #   #   # #       #     #   #     #   #       # #   #
# ########### ######### ####### # ### # ##### # ##### ##### # # ########### # # #
# #     #     #       # #     #   #   #     # # #         # # #   # #   #   # # #
# # ##### ##### ##### # # # # ##### ####### ### # ####### # # ### # # # # # # # #
# #   #   #   #     # # # # # #   #   #   #       #   #   # #     # # #   # # # #
# # # # # ### ### # # # # ### # # ### # # ########### # ####### ### # ####### # #
# # # # #   # #   # #   # #   # #   #   #   #   #   #   #     # #     # #     # #
# # # ##### # # ### ##### # ### ### ####### # ### # ##### # # ### ##### # ### # #
# # #   #   # # #   #     #   #   #       # #     # #     # #     #     #   # # #
# # ### # ### # ##### ####### ### ##### # ### ##### # ##### ####### ####### # ###
#   #   #   # #   #   #     #   #   #   #     #     #     #     #           #   #
##### # ### # ### # ### ### # # ##### ######### ##### ### ####### ############# #
# #   #   # #   # # # #   # # #     #     #   #     # #     #   # #           # #
# # ####### # # # # # # # # # ##### ####### # # ### ### ##### # # # # ####### # #
# #         # #   # #   # # #   # #   #   # # #   #   #       #   # # #     # # #
# ########### ##### ##### ### # # # # # # # # ##### # ############# ### ### # # #
#   # #       #   #   #   #   #   # #   #   #       #   #     #   #   #   # #   #
# # # # ### ### # ### # ### ############### ########### ### # ### ### ### ##### #
# # # #   #     #   # #     # #     #     #           #     #         #   #     #
# # # ### ######### # # ### # # ### # ### ########### ################# ### #####
# #   #   #     #   # #   #   #   # #   #   #         # #   #         #   # #   #
# # ### # ##### # ####### ### ##### ### ### ### ####### # # ##### ### # ### # # #
# # #   #     # #   #     #       # # # #     # #   #     #       # # #     # # #
### # ####### # ### # ### ####### # # # ##### ### # # # ########### # # ##### # #
#   # #   #   #   # #   #     #   # # # #   # #   # # #   #     #   # #     # # #
# # ### # # ### # # ######### # ### # # # # # # ### # ### # ### # ### ### # # # #
# #     # # #   # #     # #   # #   #     # # # # #   #   #   #     # # # # # # #
# ### # ### # ### ##### # # ### # ######### # # # ######### ####### # # # # ### #
# #   #     #   # #   #     # # # #         # # # #   #   # #       # #   #   # #
# ############# # # # ####### # # # # ####### # # # ### # # # ####### # ##### # #
#     #       # # # #   #     #   # # #       # # # #   #   #   #     # #     # #
##### # ##### # # # ### # # # ####### # ####### # # # ######### # ##### # ##### #
#       #       #   #     # #         #         #             #   #     #       #
################################################################# ###############

