############# ###################################################################
# #   #         #       #   #   #   #   # #   # #     #   #       #         # # #
# # ########### ####### ### # ### ##### # ### # # ##### ##### ####### ##### # # #
#   #     #   #     #   # # # #   #           #   #     #                 #     #
# # ### ##### # # ##### # # # # # # ### # # ##### ### ### # # ########### ### ###
# #   # # #   # # #     # #   # #   #   # #   #   #   # # # #         # # # #   #
##### # # # # # ### # # # # ############# # ### ##### # ##### # # ##### ### # ###
#   #   #   # #     # #         #       # #               #   # # #       #   # #
### # ##### # # # ##### ### # ####### ####### ####### ### ### ### ### ### ##### #
#         # #   #     #   # #   #   # #   #   #         #   # #   # # #     # # #
##### ### ######### ### ### # # # ### # # # ##### ### # # ### ##### ### ##### # #
# #   #     #     # # # #   # #   # # # #   #   # #   # # #     #     # # # # # #
# # ### ### # # ##### # # ##### # # # ##### ### # ##### ### ##### # # # # # # # #
#     #   #   #   # #   #     # #       #   # # #     # #   # #   # # #       # #
### # # ### # # ### # ### # ##### # ##### # # # # ##### ### # ### ### # ### # # #
#   # #   # # # # #   # # # #   # # #   # #   #     #   #     # # #   # #   #   #
### ##### ### ### # ### # ##### # # # # ### ##### # ##### ### # # ### # # # # ###
#       #   #     #     #       # # # #   #     # # #     # # # # #     # # #   #
####### ##### # ### ####### # ######### ######### ### ### # ### # ######### ### #
#       # #   # # # #     # # # # #   #             #   #             #     #   #
# # ### # # ### # # # ### # ### # ### ### ### ### ### # ####### # ### ### ### # #
# #   #   #   # # #     # # #   #     #   #   #   # # #     #   #   # #   # # # #
# ### ##### ##### ### ##### # # # ### ####### ##### # # ####### ########### # ###
# # # #   #     #   # #       # # #   #     #   #   # # # #   # # #         # # #
# # ##### # ### ### ### ##### ### # ### ### ### # ####### # ### # ##### ### # # #
# #   #     #   #     #     # #   #     # # # #     # #     #     #     #   #   #
# # ##### ##### ##### ### ### ### ### ### # # ### ### ##### ####### ######### # #
# # #   #     #         #   # #   #     #               #   #                 # #
### # # ### ####### # ####### ### ### ##### # # # ####### ##### ##### ### ##### #
#     #   # #   #   # #   #       # #     # # # # # # #   # #   #     #     #   #
##### ##### ### ### ### ### # ### # # ##### ### ### # ### # ####### #############
#       # #   #             # # # #     # # #         #   # #     #         #   #
### ##### # # ######### # ##### ######### # ### ##### ### # ##### # ########### #
#   #   # # # # #       # # #     #     #     #     #     #   # #               #
### # ### ### # ### # ### # ##### ### # # ######### ##### # # # ####### ### #####
# #   # #       #   #   #       #     #       #       # #   #   #     #   #     #
# # ### # # ################# ### ######### # ##### ### # # # # ##### ##### ### #
#   #   # # # #     #           #   #   # # # #   #     # # # #   # #     #   # #
# # # ####### ##### # ### # ######### ### # ### ####### # # ### ### ##### # # ###
# #   # # #       #   #   #   # # #     #   #       #   # # #   # #         #   #
### ### # ####### ### # ### # # # ##### # # ##### ##### # ### ### # ######### ###
# #     #     #   #   # # # # # #   # # # #       #     # # #   #           #   #
# # ##### # ##### # # ### ##### ### # # # ### ####### ##### # # ####### ### ### #
#       # #   #   # # #   # # #     #       # #   #     # # # #       # #   #   #
### ##### ##### # # ### ### # ### ### # ##### ### ### ### # ####### # # ### #####
#         # # # #       #       #   # #     # # # #         # # # # #   #       #
# # # ### # # ######### ### ##### # # # ### ### # ##### ##### # # ####### ##### #
# # #   #   #       #   #       # #   #   #   # #       #   #   #     #     #   #
### ### ########### ### ##### # ### ##### ### # ### ### # # ### # ##### # ### # #
#   #     #     # #       # # #       #   # #     # # #   #           # # #   # #
### ##### # ##### ####### # ##### ##### # # ### ##### # ########### ##### ##### #
#   #                         #   # #   # # #   #         #   #     # # #   #   #
# ######### ### ### ### # ### ##### # # ### # ### ####### ### # # # # # ##### # #
#   #       #     # #   # #         # # #     #   #       #     # #       #   # #
############################################### #################################

