################################# ###############################################
#     #       #     #   #   #         #   # #       #       #         # #   #   #
### ### # ### # ####### ### ######### ### # # ### ### ######### ### # # # ##### #
#   #   # #   # # # #         # #   #       # #   # #     # #   #   #       #   #
### # ##### # # # # ####### ### ### # ########### # # # ### ######### ##### # ###
#         # # #   #   #   # #     #     #   #   #   # #           # #   #       #
####### ### # # # ### # # # ### # # # ##### # ### # ##### ##### ### # # ##### # #
#   # # # # #   #     # #   # # #   #     # # # # #   #     #       # # #     # #
# ### # # ### # ##### ### ### ####### # ### # # ### ######### # # ##### ####### #
# #   # # #   # # # # #     #   #     #     # #       #   # # # #       #       #
# ### ### # ##### # # # ####### # ### ####### # ##### # ### # ####### # ####### #
# #                 #               # # #   # #   #   #         #   # # #       #
# ##### ### # ########### # ##### ##### ### # ##### # # ##### ### ####### ### # #
#   # # #   #           # # # #   #   # #   #   # # #   #   #     #   # #   # # #
# ### # # ### ### ### ### ### ### ### # ### # ### # ##### ### ### # ### # # ### #
#       # #     #   # #       #               #       # #     # #   # # # #   # #
# # ####### ####### # # # ########### # ### ### # ##### ##### # ##### # ### ### #
# #       #   #   # # # # #           # # # #   #       #   # # # # #       # # #
### # # # # # # # # ### ### # # ### ##### ####### ####### # ### # # ### # # # # #
#   # # # # #   # #   #   # # # #               #         #   #   #   # # #   # #
### ### ####### ### ########### ### # ############# ##### # ### # ### ####### ###
#     #   #       # # #     #     # # #   # #   #     #   # #   # #   #   # #   #
# ##### ######### ### # ### # ####### # ### ### # ##### ##### # # # ##### # # ###
#   #   # #   #   # #     # # #   #   #     #     # #   # #   # #     #     # # #
######### ### ### # ### ### ### ####### ### ### ### # ### ### # ### ### ### ### #
# #           #   # # #   # # # #     #   #   # #             #   # # #   #   # #
# ### ##### ### ### # ### # # # ### ######### # # ####### ####### # # ##### # # #
#       #   #     #       # #         #         #   #   #   # #   #         # # #
### # ### ####### # ############# ### ### # ### ##### # ### # ############# ### #
#   # #   #   # # #     #     #     # #   #   # # #   # #   # # #         #     #
##### ####### # # # ##### # ##### ########### ### ### ####### # # ######### ### #
#     #   #     #     # # #   # #   # #   # # # #           # #         #     # #
# ####### ##### ### ### # # ### # # # ### # ### # ### ####### # ### ########### #
#     #   # # #           # # #   #   #   #     #   # #     #   #       #       #
### ##### # # ####### ### # # # # # ### ####### ##### ### # # ##### ####### #####
#     # #   #   #       # # #   # # # #             # #   # #   # # #   #   #   #
# ### # ### ### ##### ### ### ####### # ############# ### ####### # # ### ##### #
# #   #       #   #   #   # #   #   #     # # #           #     # #     #   # # #
##### ### ### ### # # # # # ### # ####### # # # # # ### ####### # ##### # # # # #
# #         # #   # # # # #       #   #   # # # # # #         #           # #   #
# # ##### ##### # # # # ##### ### ### # # # # # ######### ### ######### ####### #
#   #   #       # # # # #     # # #   # # #     #     #   # #   #     #     #   #
# ### # ### ##### # ######### # # ### ### # ######### ##### # ### # # ### ##### #
# #   #   #   #     #     #   #   #   # #   # #   # #     # #     # #   # # #   #
# # ######### # # # ### ### # ### ### # # ### # ### ### ### # ########### # ### #
#   #         # # #   #     #   #   #     #               #       #             #
### ####### ############# # ### ################### ### # # ##### ##### ##### # #
#       #     # # #       #   #     #       #       # # # # #     #     #     # #
# ########### # # ### ### # ##### ### ### ### ### # # ### ### ### ### ##### ### #
#     #       # # #   # # #   #       #   # #   # # #         #       # # #   # #
# ### ### # ### # # # # # # ######### ### # # ######### # ########### # # # ### #
# #   # # #         #   # #   #   #   #           #   # # #         # # #     # #
# ### # # # ########### ##### # # # ########### ##### ### # ### # # # # ####### #
#   #   # #   #       # # # # # # #   # #     #   #   #       # # # #   #   #   #
# ##### ##### ### ##### # # # # ### ### # # # ##### ####### ####### ### ### ### #
#     #     # #           #       # #     # #                   #   #     #     #
############################################################### #################

