####################### #########################################################
#       #     #     #   #     # # # #     # #       #       #         #     #   #
##### # # # ### # ##### ##### # # # ##### # ### ### ### # ####### ### ##### ### #
#   # #   #   # #   #     # #   #   # #           # # # # #     # #           # #
### # ### # ### ### # ### # ### # ### # ### ##### # # # ### # ### ##### # ##### #
#   # # # # #   # #   # # #   #     # # #       # #       # #     # #   # #   # #
### ### # ##### # # ### ##### # ##### ### ### ##### ##### ##### ### ### ### ### #
#       # #     #     # # # # # # # #     #     # #   #         # #   # # #     #
### ##### ##### ### ### # # # # # # ### ##### ### ### ### ##### # # ### # # ### #
#       # # #     # #   #           #   # # # # #       # #   #   # #       #   #
# # # ### # # ### ### ### ### ####### ### # # # # # ####### ##### # ### ### # # #
# # #     #   #     #       #     #       #   #   #     # #     # #   # # # # # #
### ########### ##### ####### # ### # ################### # # # ##### # # #######
#         # #     #   #       # #   # #         # # #       # # #         #     #
### # ##### # ### # ### ### ### # # ### # ### ### # ### ##### ##### ##### # #####
#   #         #     #   #   #     #     # #     #       #               #       #
# # # ####### ### # ####### ##### # ### ### ######### # # ######### #############
# # #   # #     # # #         #   # # # #   #     #   # # # #     #         # # #
# # ##### # ### ############# ####### ##### # ##### ##### # # ##### ##### ### # #
# # #   #     #           # # #   #     #   # #   #     # #       #     #     # #
### # # ####### ### # ### # ##### ### ##### # ### ### ####### ################# #
#   # #         #   # #   #         # # # # #     # # #     #     # # #       # #
# ### # ### ######### # # # # ### ### # # ### # # # # # ### ### ### # # ##### # #
# #   # #   # #     # # #   # #   #       #   # #         # #     #       #     #
##### ##### # # # ### ### ### ######### # ########### ######### # # # ##### # ###
#     # #   # # # #     # # # # #       #   #       #     # #   # # #   # # # # #
### # # # ### # ### ####### ### # ##### ### # ######### ### # ####### ### # # # #
#   #   #   #         #     # # #     # #                       #   #     # #   #
### ##### ### ####### ### ### # # # ##### # # ########### ### ### ### # ##### # #
# # #   #   # #       #     #   # #   #   # # #         # #   # # # # #   #   # #
# ### # ####### # ### # ### ### ####### ##### # ####### # ### # # # ##### #######
#     #     # # # # #   # #   #   #   #   #   # #       #   # #   #       #     #
# ### # # ### # ### ##### ### # ##### # ##### ### ##### ### # # # # ####### ### #
# #   # #         #     #   # #       #   # # #     #       #   #     #   #   # #
### # ######### ####### # ######### ### # # ### ### ############### ### ####### #
#   # #   #   # # #       #   # #   #   # # # # #   # #       #           # # # #
# # ##### ### # # ### ##### ### ### ##### # # ####### ##### ### ##### ##### # # #
# # #       #             # #             #   #   # # #     # #   # #   #       #
# ##### # ### # ########### # ### ### ####### ### # # ### ### # ### ########### #
#   #   #   # # # #             #   # #             #   #   #                   #
##### ### # # # # ### # ################### ### # # # ### ####### ##### #########
# # # #   #   #   # # #     #     #           # # #       #           #     #   #
# # ### # ### ### # ##### ### ####### ############### ##### ####### ########### #
#       #   # #       #           #           #     #   #   #         #       # #
# ### ### ######### ############### ##### ##### ### ########### # ### ##### ### #
#   # # #     # #   #             #   # #     #   #             #   #   #       #
# ##### ##### # ### ### ######### ##### # # ####### ################### ##### ###
#   #   #     #         #         #       #   #   #   # #       #       #       #
##### ### ### # # ################# ##### ##### # # # # # ########### ### #######
#   #     #   # #     #   #           # # #     #   # #                         #
### # ##### ##### ####### # ### ##### # ##### # ##### ### ### # # ### ##### # ###
#     #         # #         #     # #         # #       # #   # # #   # #   #   #
# # # # ####### ##### # ##### ##### ##### ### ######### ### ####### # # # ##### #
# # # #   #         # #     # #           #           # # #   #   # # #   #   # #
# # ####### ####### ### # ### # # ##### # ### ### ####### # # # ### ##### ### # #
# #     #   #         # #   # # # #     #   #   #       #   # #       #   #     #
############################### #################################################

