##################################################################### ###########
#     #   #       #           #   #     #         #   #   #   #     #       #   #
# ### ### ##### ########### # ### ##### # # # ### ### # # ### ### # # ### ### ###
# # #     #           #   # #   #         # # #     #   # #       #     # #     #
### # ########### # ##### # ####### # # ### ### ### ### # ### ### # ### # # ### #
# #     # # # #   #   #     #       # # #     # #   # # # #     # #   # #     # #
# ### ### # # # ##### # ### ############### # ####### ### # ### # # ### ### ### #
# #     # #   # # #   #   # #   #   #       #     #     #     # # # # #   # #   #
# # # # # ### ### ### # ##### # ### ############# ### # ### ### # ### ####### ###
#   # # # #   #   #       #   # #       # # #   #     #     #   #     #     # # #
##### # # # # ### ### ####### # ### # ### # # # # # ####### # ######### # ##### #
# #   #     #     #     #     # # # #   # #   # # # # #   # # #   # # # #       #
# # ### # # ####### ### ##### ### # # ### # ##### ### # ######### # # ####### ###
#     # # #     #   #     #     # # #           #         # # #     #     #   # #
### ##### ### ##### ##### # ### # # ### ### ##### # # ##### # ### # ### ##### # #
#   #     #   # #     #   # #     # #   # #     # # # # # #   #   #   #         #
# ######### # # ### # # # # ########### # ### ### ### # # # # ### ### # # ### ###
#     #   # #       # # # #     # # #   # #   #     # # #   # # # #   # # # # # #
######### # ##### # ### ### # # # # # ### ##### ### # # ### ### # # # # ### ### #
# #     #   #     # # #     # # #     #     #     # #   # #   #   # # # #   #   #
# # ##### # # # ### # ### ### # ### # # # ### ##### # ### # ##### ### # ### # ###
#       # # # # # #     #   # # #   #   #   # # #   #         #     #     # #   #
### ##### ####### # ########### # # # ######### ### ### ############### ### # ###
#   # #         #   # #   #   #   # # # # # #       #       #   # # #   # # #   #
### # ### ########### ### # ######### # # # # ### ### # # ### ### # # # # # ### #
#   #       #   # #     #         #         #   #   # # #     #     # # # # #   #
# ### # # ##### # ### ### ### ### # ##### # # # # ####### ### ##### # ### # # ###
#     # #             #   #   #       #   #   # #   #   # #   # #   #     #     #
### # ### ########### # ### # # ####### ############# ####### # # # # ### # #####
#   # #           #   # #   # # #             #     # # #         #   # #       #
### ### # ### ####### # # # # ### ##### ### ##### ### # ######### # ### ### ### #
#     # # #         # # # # #   #   #     # #         #   #   #   #       # #   #
# ##### ##### # ### ##### # ##### ### ### ##### ### # ### # ### # # # ##### ### #
# #     #     #   #     # #   #   # # #   #   # #   # #     #   # # # #   # #   #
### # # ####### ##### ####### # ### ######### ### # # ### ### ### ##### ### # # #
# # # #       #   #         # # # # #   # #     # # #       #   # #         # # #
# ### ####### ####### ### # # ### # # ### # ### # ### ### ##### # ########### ###
#     # #         #   #   # # # #       #   #     #     #     # #   #   #       #
# ### # # # # # ### # ### ##### # # ### ##### ######### ### ### # ### # # # #####
# # #   # # # # # # # #           # #   #   # #   #       #     # #   # # # #   #
### # ##### ##### # ### ##### ######### # ##### ### # ############# ### ### ### #
# #     #   #     # #     #   # #   #   # #     # # #     # #   #   #   #       #
# ### ##### # ### # ### ### ### # ### ### ### ### ##### # # # ######### # ##### #
#   # # #   # # #   #     # #   #       #     #         # #     # # #   #   # # #
# # # # ####### # ### ### ##### ####### # ### ##### # ### # ### # # ### ### # # #
# #     #   #       # #       # # #     #   #       # #   #   # #   #       #   #
# # # # ### # # ######### ##### # ############# ######### ### ### # ### # ### # #
# # # #     # # #   # #           # #             # #   #   #   # # # # #   # # #
####### # ##### ### # # ##### # ### ### ### ####### # ##### # ### ### ### ### ###
#       #   #     #   # #     #   # # #   #   # #           #       # #   #     #
############# # ##### # ### ####### # ######### ####### ##### ##### # ### #######
# #   #       # #     #   #         #           #   # #   # #   # #         #   #
# ### ##### ### # ########### ############# ####### # ##### # ### ### # # ### # #
#           #         # #         #   #   # #     #     # # #   #     # #     # #
# ####### ##### ####### # ### ####### # # # # ### ### ### # # ##### ### ### ### #
#   #         #       #   #             #       # #           #     #   #     # #
############################################################### #################

