########### #####################################################################
# # #       #         #         # #   #     # #   #         # #     # #   #     #
# # # ##### ##### ##### # ####### # ##### ### # ##### ### ### ### # # # # ### ###
#     #   #         #   # # #     #         #         #     # # # # #   #       #
##### ### # ### ### # # ### # # # # # ### ### ##### ### # ### # ### # ### ##### #
# # #   #   #     # # # #   # # # # # #         # # #   # # #   # # # #   #   # #
# # ### ####### ### ### # ####### ##### # ##### # ######### ### # # ##### # ### #
#         #     # # # # # #         #   # # #               #   #   #   #   #   #
####### # ####### # # # # ####### ##### ### ##### ##### ### # # # ##### # # ### #
#     # #   # #   #   #   #   #           #     # # #   #     #       #   #   # #
# # # # ### # ### ##### # # ### ### # ##### # # ### # ##### ##### # ### ####### #
# # # #   #           # # #       # # # # # # #     #   #     # # #     #   # # #
##### # # # ##### ### ### ### ####### # # ### ######### ### ### ##### ### # # ###
#     # # #   #   #     #     #     # #     # # # #       #     #   #   # #     #
##### ### # # ##### ### ### # ### ####### # # # # # ### ### ##### ####### #######
# #       # #   # #   #     # #     #     # # #     #   # #     #       #   # # #
# # ##### ### ### # # ### ### ##### ####### # # ### ### # ##### ##### # # ### # #
# # #     #     #   #   # #     #         #       # #       # #   #   # #       #
# # # ##### ############# ### # ### ######### ######### # ### ### ### # # ### ###
#   #   #   #   #   #   #   # #       # #   # #     #   # # # # # # # #   #   # #
# ######### # # # ### ##### ### ####### ### ##### ### ### # # # ### ####### ### #
#       # # # #       #   #   #       #       #       #   # #         #       # #
# ##### # ### ####### # ##### ##### ##### # ##### # ####### ### # # # ##### ### #
# #   # #     # #   #     #   #   #   #   # #     #   # # # # # # # # # # # #   #
### # # ### ### ### ### # ### # ####### ##### ####### # # # # ##### ### # # # ###
#   #                 # #   #       #               #       #     # #         # #
# # ##### ### ### # ##### # # # ##### ### # ######### ### ### ##### ####### # # #
# #     #   # # # # #     # # # #   #   # #     #       #   #     # # #     # # #
##### ### ##### ### ####### # ##### ### # # ####### # ### # # ### # # ##### ### #
#       # #   #     # # #   # # #   #   # #   # # # #   # #   #                 #
####### ### ##### # # # # ### # # ### ##### # # # ##### ################### #####
#       #       # # #   #   #   #     # # # # #   #       #               # # # #
### ### ### ### # # # ########### # ### # # ### ####### ### # ##### # ### # # # #
#   #   #   # # # #   #     #     #       #   # #     #   # #   # # # # # # #   #
### ### # ### # # ######### # ########### ##### ##### # ####### # ### # ##### # #
#   #   #     #   #   #   # # #     #     #           # #           #         # #
# # ############# # ### ### ####### # # ####### # ### ### # ### ######### # #####
# # # # #   # #         #   #       # #         # #       # #         #   # # # #
# ### # # # # # # # ### # ### # ####### ######### ### ##### # ####### ##### # # #
# # #   # #     # #   #   #   # # #             # # #     # #   #       #       #
# # ### ##### ######### ### ##### ### ### # # # ### ### ######### # # # ### ### #
# # #     #     #   #     #     #       # # # #   #     #     #   # # # # #   # #
# # ##### ### ##### ########### ######### ### ####### ####### ##### # # # # ### #
# # #             #     #       # #       #       #           #   # # #   #   # #
### # ######### # # # ##### ### # ##### # # ####### ### ### ### ### # # ### #####
# #   #       # #   #         #   # #   # #   # #   # # #     #     # # # # # # #
# ### # # ############# ####### # # ####### ### ### # ##### ##### # # ### # # # #
#     # # #       # #     #     # #           #         #   # #   # #   #     # #
##### ### ### ##### ##### ### ### ############### # # ####### ### # ### ##### # #
# #                 #     # #   #   # #           # # #     #     #   #     #   #
# # # # ### ############### ####### # ### ### ##### # # ########### # ### #######
#   # #   #             #       #     # # #       # #     #   #     # #         #
### ######### ### # # ##### ### # ##### ### ### ####### # # # # ####### ####### #
#       #       # # # #       #           # #   #       #   # #     #       #   #
################################################### #############################

