############################################# ###################################
#       # #   #       #   #   #         # #   # # #     # #   # #     #   # #   #
# ##### # # ### ### ##### ### # # ####### ### # # # # # # # ### # ####### # # # #
# # #   #       # # # # #   #   #     #       #   # # # #     #     #     #   # #
### ### ### # ### ### # # # ### ### # # ### ##### ### ##### ####### ### # # # # #
# # #   # # #     # #   # # # # #   #   #   #               #   #   #   # # # # #
# # # ### # # # # # ### ### # ######### ##### # ##### # ##### ### # # ##### ### #
#   # #   # # # # #     # #   #   #   #       # # #   # #         #   #   # # # #
# ### ### # ##### # ### # ### # ##### # # # # # # # # ### ######### # ### # # # #
#           #     # # #   # # #         # # # # #   #   #         # # #       # #
####### # ### # ### # ##### # # ####### # ### ### ##### # ### # ##### ##### # ###
#     # # # # #     #     #       # # # #   # # #   #       # # #   # #     #   #
##### # ### # ####### # ### ####### # # ####### # ### # # # ##### ##### # ##### #
#       # #       #   #   #     #   #   # #   # # #   # # # #         # #     # #
##### # # # # ##### ##### # ### # # ##### # ### ####### ##### # # ####### ##### #
# #   # #   #       #   #     #   # #   #           # #   #   # # # #         # #
# ### ##### ### # # ### ### ##### ##### ##### ##### # ### # ### # # ######### # #
#   #   #     # # # #   #   #   #           # #     #     #   # # #   # # # # # #
# # # # ##### ### # # # # ### # # ### ### # # ### ### # # # # # # # # # # # ### #
# #   # #   #   # # # # # #   # #   # # # #     #   # # #   # # # # #   #   #   #
# # # # # ##### ##### # ### # ### ### # # ##### ##### ####### ##### # ##### # ###
# # # # #           # #     #       #   #   #   #       #   #   # # #     #     #
### # # # ########### # # ####### ##### # ######### ### ### # ### # ####### # ###
#   # # # # #     # # # # # #     #   # #   #       #   #     # #   #   # # # # #
# ####### # ### ### ##### # ### # # # ####### ##### # ##### ### # ##### # ### # #
# # # # #   # #   #   #       # #   #   #     #     # # #       #   #   # # #   #
### # # # ### # # # # # # ############# ##### ### ##### ####### # ### # # # # ###
#   # # # #   # #   # # #   # #   #     # # # # #             # #     # #       #
# ### # ##### ##### ### ##### # ####### # # ### ### # ##### ##### # ##### #######
# #             #   #   # #     #     #   #   # #   # #       #   # #   #     # #
# # ####### ##### ##### # # ### # # ##### # ### ####### # ### # ####### # ##### #
#         # # #   #     # # #     # #     #             # # # #   #     #       #
# # ##### # # ### # # # # ####### ######### ### ########### # # ### ### # #######
# # #   # # #       # #           #   #       #   #       #   #       #         #
##### ### # ######### ##### # ####### ### ### ##### ### # ### # ### ### #########
#         # #           # # #   # #     #   # #     #   #       #     # #       #
# ##### ##### ### # ##### # ### # # # # # ##### ##### ####### # ### ########### #
#   #         #   #       # # # #   # #   # # # #   # # #   # # # # # # #   #   #
# ########### ##### # ####### ####### ##### # ### # ### ### ### # # # # # ### ###
#   # #     #   # # # #             #     #     # # #       # # # #     #   #   #
##### ##### # ### ### ### ####### ### ######### ### # # ##### # # # ### # # # # #
#       #           # # #     #     #       # #   # # #       # # #   #   #   # #
### # ##### ####### ### # ### # # # ### ##### # ### ####### ##### # ### ####### #
#   # #   # #   #     #   #   # # # #     #         # #           # #   #   #   #
# # ##### ##### # # ### # ######### # ### # ### ##### ##### ##### # ##### #######
# #   #       #   # #   #     #         #     #   #           # #     #     # # #
# # ### ####### ### ### ####### # # ########### ### ######### # ##### # # ### # #
# # #   #         # # # #   # # # # #   #         #     #     # #     # #       #
### ### ### # ####### # ### # ### ### ### ### ### ######### ### ### ##### ### ###
#   # #     #       #     #           #   #     #   # #       #           #     #
# # # # ############# ##### ####### ########### # ### ### # ####### # ######### #
# #           # #     #       # #     #       # #   # #   #   #     #       #   #
# ##### # ##### # # ### ### ### ##### # ########### # # ######### ##### ### #####
# # #   #       # # # # #           #     #     #   #     #   #     #   #       #
# # # ### ######### # # ### ### ### ### # # ### # ### ### ### ##### ##### #######
# #   #       #       # #     #   #   # # # #     #   #   #             #       #
####################################### #########################################

