############################# ###################################################
# #   #           #   #         #     # # #       #   # #       # # # #     # # #
# ### ### # ### # ### ######### ### # # # # # # ##### # ##### ### # # # ##### # #
#     # # # #   # #           #   # #   # # # # #   # #         #       #   #   #
##### # ### # ########### # ### ##### # # # ####### # # ### ### ### ####### ### #
# #   #     #   #       # # # # #   # #       #       #   # #   #   #   #   # # #
# ### # ### ####### # ##### # # # ######### # ##### ### ##### # # # # ### ### # #
#         # #       # # #   #     #     # # #   #       #   # # # # # #     #   #
# # # # ### # # # # ### # ### # ### ##### ### ### ### # ### # ### ### ### # # # #
# # # # #   # # # # # #       #   #             #   # # # # # # #     # # # # # #
### # ####### # ### # ##### ### # ### ######### ### # ### # ### ### ### # ##### #
#   #       # #   #   #       # #     # # # # # #   # #   #       #   #   # #   #
### ##### ######### # ### ### # # ##### # # # ##### ### ### # ### # ### # # # ###
#   # #     #   #   # #   #   # #       #     #     #   #   # #     # # # #     #
##### # # # # ####### ### ### ### # # ### ### # # ### ### ##### ##### # ### # ###
#       # # # # # # #     # # #   # #   # #     #   # #   #   #         #   # # #
### ### ##### # # # # ##### ### ### ### ##### # ### # ### # # ####### ### # ### #
#   #   #   #       #         # # # #   # #   # #     #     #     #   #   #     #
# ### # # ##### ### # # ### ##### # ### # ### ######### # ### ######### # #######
# #   # #   #   #     #   # #   # # #   #     # # #     #   #   #   # # #     # #
# # ### ### ####### ##### ##### # # ####### ### # # ########### ### # ### ##### #
# # #   #               # # # #       # #   #               # # #             # #
# # ##### # # # ### ### ### # ##### # # # # ### ####### ##### # ##### ##### # # #
# #       # # # #     # #           #     #   #     # # # #   #         # # #   #
### # # ### ################# # # ####### ######### # ### # ### # # ### # # # ###
# # # #   #       #         # # # #           #   #   #         # #   #   # #   #
# ######### # # # # ### # ### ######### # ####### # ### ############### ### # # #
#       #   # # #   #   # # # # #     # #   #     #   #     # # #     #   # # # #
##### ### ##### ######### # ### # ####### ### ####### ### # # # # ####### # #####
#     #   # #   #   #   # #   #   # # # # # #       #   # # #       # #   #   # #
# ### ##### ### # ##### ### # # ### # # # # ####### ### ######### ### # # # ### #
#   #   # #     #     #   # #   # #             #         #       #   # # #     #
# # ##### # # # # ### # ### ##### ### ######### ### ### ### ##### # ### ### # ###
# #         # #   #     #     #       # #     # # # #         #   #       # #   #
# # ### # ##### ##### # # ####### ##### ##### ### # ### # ##### ####### ####### #
# # #   # #       #   #         #   # #               # #     # # #         #   #
# ### ####### ########### ######### # ### # # ####### ##### ### # ##### ##### ###
# #       # #       #       #     #   #   # # #     # # #   #     # # # # # #   #
# ### # ### ##### ##### ##### ### ### # # # # # ### # # # ### ##### # ### # #####
# #   #   #     # #     #     #         # # # #   #   #     # # #   #     #     #
# ### # ### ####### ##### ##### ### ##### ####### ######### ### # ####### # # ###
#   # #     # #   # #   #   #     #     # #     # #               #   # #   #   #
# ####### ### ### ### ######### ### # ##### ### ####### # ### ### ### # ### ### #
#       # #         #     #   # #   #     # # #       # # # #   # # #     #   # #
############# ### # # ### # ### ### # ####### # ####### ### ##### # # # ### ### #
#   # #     # #   #   # #       # # # #                 #   #   #     # #     # #
### # ### ########### # ### ### # ### ### # ##### # ##### ### # # ##### # ### # #
#     #       #         #     #   #     # # #     #           # # #         # # #
### # # ##### ### ##### ### # # # # ######### # # # ### ##################### ###
#   #     #   #       # # # # # # #   #   # # # # # #     #     # # #         # #
# ##### ### # # # ### # # ##### ######### # # ######### # ### # # # ######### # #
# #   # #   #   # # # #   #       #   #       #       # #     #       #     #   #
# # ### ### # # ### ### # ########### ### ### # # ##################### ####### #
# # #     # # # # #   # #     #           #   # # # #         # #     #         #
# # # ####### ### # ########### ### # ### # # # # # ### ### # # # # # ### # ### #
#   #       #               #   #   # #   # #   #         # #   # # #     #   # #
########################################################################### #####

