##################################################################### ###########
# #         #             #       #     #         #           #     # #   # #   #
# # ### # ##### ### ######### ##### ### # # ### ######### ### ### ### # ### ### #
#     # #         # # #       #       #   #   #         # #     #   # #     #   #
# ##### ### ### ### # # ### ####### ####### ### ### ####### ### # ### ##### ### #
# # #     # #     #     #   # #   # #   #   #   # # #   #   # #   #         # # #
### ### ### ##### ######### # # # ### ### # ### # # # # ##### # # ### # ### # # #
#     #   # #   # #           # # # #   # #   # # # # # #     # #   # #   # # # #
### ##### # ### # ### ### ##### # # # ##### ### # # # # # # ### ##### ### ### # #
#   #   # # #   # # # # #     # #       #     #   # # # # #     # # #   # # #   #
### ### ####### ### # # ### ### # ##### ### ##### # # ##### ##### # # ##### # ###
#     # #     #       #     # # #   # # # #   # # # #         #   #   # #       #
# # # # # ##### ##### ##### # ### # # # # # ### # ### ##### # # # # # # ##### ###
# # # #           #     #       # # #     #     # #   #   # # # # # #           #
# ### # # ################### ######### ### ##### # # ### ##### ######### ##### #
#   # # # #           # #     #   # #     # # #     #         # #   #     #   # #
### ##### ##### ##### # # # ### ### # ### ### # # # ### ##### # # ####### # # # #
# #       #   #     # #   # #     #   #         # #   #   #     #       # # # # #
# ##### # ### # ### # ### ####### # # ### ######### # ####### ### # ### # # #####
#     # #   # #   # # #   # # # #   #   #       #   #     # #     # #       #   #
# # # ####### ### ##### ### # # # ####### # ############# # ### ######### ### ###
# # #   #     #             #   # #       #     # # # #   #   # # #         # # #
# ##### ### ############# ##### ### # ########### # # ####### ### ##### ##### # #
#   # # #   #             #   # #   #   #       #       #   #   #     #         #
### # # # # ### ### ### ##### # ### # # ### # ##### ### # # ### # ##### # ### ###
# # #     #   # # #   #   #       # # # #   # #       #   #         #   #   #   #
# ######### ### # ######### ####### ##### ### ####### # # ####### ### ###########
#         # #       #   #           #   #   #   #     # #   #   #   #     #   # #
##### ### # ####### ### # ##### ##### ######### # ####### ##### ### # ####### # #
# #   # # #                 # # #   #     # #   #       # #   #     #   #   #   #
# # # # ####### # ######### # ### ####### # ### ########### ##### ##### # ##### #
# # #   # #   # #     # # #         #   #   #                           #       #
# ### ### # ##### ##### # # # ######### # # ### ### ####### # ### ### ##### #####
#         #   # # # #       #   # # #     # #   # #       # # # # #   # # #     #
##### ####### # # # ####### ##### # ### # # # # # ############# ####### # # ### #
#         #         #   #   # #         # #   #     #   #       # #   # #     # #
### ####### ### ### # ##### # # ##### ######### ### # # ### # # # # ### # ### ###
# #       #   # #         # #     # # #         #   # #   # # #   # #   # # #   #
# ####### # ### ####### ### ### # # ### ############### ##### # ### # # ### # # #
#     #     # # # # #     # #   #   #   #   # # #       #     #       #       # #
##### # ##### # # # ### ####### ##### # ### # # ### # # # ######### # ######### #
# #   # #   # #   #   # #     #   #   #   # #       # # # # # #   # # #   # #   #
# ### ##### # ##### ### # ##### # ### # ### # ######### # # # ### # ### # # # # #
#   #             # #     #     #   # #               #   #           # #   # # #
### # ####### # # # ##### # ##### ### ####### ### # # # # ### ####### ### #######
#   #   #     # # #       # # # # # #       # #   # # # # #     # # #           #
# # # ### ### ### # ### ##### # # # # # ######### ### # # ### ### # ##### ##### #
# #   #     #   # # #       # #   # # #   # #       # # #   #   # #   # # #     #
####### ######### ########### ### # # # ### ### ### ######### ### # ### ### # ###
# #     #   #   #   # #           # # #       #   #   #     # #   #   #   # #   #
# # ####### ### ### # # ####### ### ########### ### ### ######### # # ### # ### #
# # #   #             # #       #   # #   # #   #               #   #         # #
# # ### # ####### ### # # # ### # # # # ### # ### ##### # # # ####### # ##### # #
#       #     #     #   # # #     #         # #   #     # # #     #   #     # # #
##### # ####### ### # ##### ### ##### ##### ### ##### ##### ### ##### # # # ### #
#     #   #     #   #     # #   #       #     # #       #     # #     # # #   # #
########################################################################### #####

