######################################### #######################################
# #     # # # # #   #   #   #         #     #     #   #             #     #     #
# # # ### # # # ### ### # ##### # ##### ### # ### ### ############# ### ### ### #
#   # #         #     #     # # #   # # # # # #     # #       # #     # #   #   #
# # ######### ####### # # # # ### ### ### # # ####### # # ### # # ##### # # #####
# # #         #   # #   # # # # #     # #     # # # # # # #       #   #   # # # #
# # # # # ### ### # # # # ### # ##### # # ### # # # # # ### ####### ### ### # # #
# #   # # #   #       # # #   #   #   #   #     #         #   # #         #     #
### # ####### # ### # ### ### # ##### # # # # ### ########### # ### ##### ### ###
# # # #           # # #           # #   # # #     #     #             #   #   # #
# # ######### ### ############# ### ### # ########### ### # ####### ######### # #
#     #   #   # # # #   # # #   #   #   #   # #   #   # # #     #     #   #     #
### ### # # ### # # # # # # # ### # ### ##### # ### ### # ### ##### ##### # ### #
#     # #   # #   # # #           # #   #   #   # #       #       # # #   # #   #
# ####### ### ##### ########### # ##### # ### ### ####### # ### ### # # ### # ###
#       #   #       # #     #   # # #         #       #   # # # # #   #   # #   #
######### ### # ### # # ##### # ### ### # ####### # ### ##### # # ### # # #######
#       #     #   #   #     # #     # # # #     # #   #   #   #   #   # #   #   #
### ### # ### # ### ### ### ### # ### # ##### ##### # # ### # # ########### ### #
# # #   #   # #   #   # #     # # #   # #         # #   # # # #       # #   #   #
# # # # ####### ### ####### ####### # # # ### # # ####### ### # # ##### # # # ###
#   # #         #     #             #       # # #       # #   # # #   #   # #   #
### # # # ##### ### # # ##### ####### ########### # ### # ### # ### ### ####### #
#   # # # #   #   # # #   #   # #   #   #   #     # #       #     #           # #
# # ####### ##### # ### # ##### # ##### # ####### # # ##### ##### # ### ####### #
# # # #   #   # # #   # # #   #     #       #     # # #   #   #     # #   #     #
##### ### # ### ### # ####### ##### # ### ### ### # # ### ### ##### # ### ### # #
#   # #     #   #   #     #     # #   #   # # #   # # # #   # # #   #         # #
# ### # ####### # ##### ##### ### # ##### # # ### ##### # ##### # ##### ##### ###
#       #     #       #     #           # # #   #     #       # # # # # # #   # #
####### ##### ######### ### # # ####### # # ### # # # # ####### ### # ### ### # #
#   #   # #     # #     #     # #       #   #   # # #                   #       #
# ### # # # ### # ####### # ############### ####### ########### ##### # ### #####
#     #     #   #   #   # #       #               # #   #           # # # #   # #
# # # # # ######### ### ##### ####### ### # # # ### ### # ##### ### ##### # # # #
# # # # #         #   #     # # #       # # # # # #     # # # #   # #       #   #
### ##### ##### # ### # ### # # ### ### # # ##### ######### # # # ### ##### ### #
# #     #   #   # #   #   #   #   # #   # # #   #   #         # # #     # # #   #
# ############### ### ##### ### ### ### ####### ### ##### ########### ### # # ###
#           #     #   # # #     # # #             # #   #         #     # # # # #
####### ### # ### # ### # # ##### ######### ####### ### ### ####### # ### ### # #
#   # #   #     #   #       # #         #             #         #   # #     # # #
# # # ##### ##### ### ####### # ##### ##### # ### ##### ### ### ### ####### ### #
# # #       #     #       #   # # # # #     # # #   #     #   # # #   #       # #
# # # ### ### # ####### ### ### # # ##### # ### ### ####### ##### # ### ##### # #
# #     #   # #           #         #     #     #     #             #     #     #
### # # # # ######### ### ######### # # # ############### # ### # # # # ### ### #
#   # # # #   #   #     #     # #     # #     #         # # #   # #   # #     # #
### # # ### ##### # # ##### ### ### ##### ### ### ##### ##### ####### # ##### ###
#   # # #     #   # # # #         #   #   # #   #     #       #     # #     #   #
##### ########### ##### ### # # ####### ### ##### # # ########### ##### ####### #
# # #       # #     #       # #   #             # # #         # #         # #   #
# # ### ##### ### # # # ############# # ### # ### ####### # # # ####### # # # ###
#         #       #   #           #   #   # # #   #       # #         # #   #   #
####################### #########################################################

