############### #################################################################
#   #     # # #   #     # #     #         #   #     #   # #     #   #           #
### ### # # # ### # ##### # ##### # ### ### # ### ##### # # # ##### # ###########
#       # #     # #   #       #   #   # # # #       #       # # #     # #     # #
# ############# # # # # # # ##### ##### # # # # ### # # # # # # # # # # # # # # #
#             #     # # # # # #   #   # # # # # #     # # # # #   # #     # #   #
# ##### ############# ##### # ##### ### # # ########### ####### ##### # ##### # #
#   #   #             #           #             #     # #           # #   #   # #
# ### # ### ### ##### ##### ##### ####### ########### # ######### # ### # #######
# # # #   #   # #   #     #   #           #       #     #         #   # #     # #
# # # ##### # ### ### ### # # ##### # # # # ##### # ### # # # # ##### ### ### # #
# #     # # # #   #     #   # #     # # # #     #   #     # # # #   #   #   #   #
# # ### # ####### # ### # ######### ########### # ############# ### ### ### ### #
# # # # #   # #   # #   #     #   # # # #   # # # # #             #     # #   # #
##### # # # # ### ####### ####### ### # # ### ### # ### ### # ### ### ### # #####
#     # # #   # #   # #         # #   #   #     # # # # #   #   # # # #   #   # #
### ### ### # # # ### ##### # ### ### # ####### # # # # # ##### ### # ### # ### #
# #     #   # # #   #   #   #     #   # #         #     # # #     # # #     #   #
# ### ### ### # ### # ########### ### # ########### # ##### # # ### # # ### # # #
# #     # #   #         # #               #   #     # #     # #     # # #     # #
# # # ##### ##### ##### # ##### # # ######### ####### # ######### ########### ###
# # # #   # # # # #         #   # #     #         #         #     #       # #   #
# # ### # # # # ### # # # ######### ### # ### ### # ############# ### ##### #####
# #     # # # # #   # # # #       #   #   #     # #   #       # #     #   #     #
# ##### # # # # ##### ### ### # ####### ####### # ####### ##### ##### # # # #####
# # #   #         #   # # # # # # #   # # #     #   #               #   #       #
# # ### # ####### ### # ### # # # ### # # ##### ### ### # ############# # #######
#       #   # # #         #   #   #         #   #   # # #   # #   # #   #   #   #
######### ### # ### ### ######### # ##### # ######### # # # # ### # ##### ### ###
# #     # #   #       #               #   #       #   # # #     #     #         #
# ##### # ### # ######### ####### ### # # # # ##### # # ### # ### ### ##### #####
# #   #   #     # # #       #   #   # # # # #     # #   #   # #     #   #     # #
# # ##### ####### # ### ### # ##### ### # # ##### ### ######### # # # ######### #
#   #     # #       # #   # #       #   # #     #     #         # # # #     #   #
### ### # # ####### # ### ##### ####### # ### # # # # ######### ### # ### ### # #
#     # # # #   #   #   # #       #     # #   # # # # #           # # #       # #
# # ### ### # # # ### ######### # ### ############# # ### # ####### ####### # ###
# # #   #   # # #   # #       # # #       # #   #   #     # #     # #       #   #
# # ### # ### ### ### ### ### # # ##### # # # # # ########### ##### ### ##### ###
# #             # #   #   #     # #   # #   # # # # #       #     # #   #   #   #
### ##### ####### ### # ####### # # ########### # # # ####### ##### ##### ### # #
# # #     #   #   #         #   #     #           # #   #   #           # #   # #
# # ### ##### ### # ### # ############### # ### ### ### ### # ### ##### # ### # #
#   #   #     #   # #   # #     # #       #   #   # # #         # #         # # #
# # ### ##### ### # ### # ### ### # ####### ####### # # # ### ####### ### # # # #
# # #   #             # #     # #   #             #   # # #   #       # # #   # #
# ### ####### # # ####### # # # ######### # # # ### # # ####### ### # # #########
#   #     #   # #     #   # #         #   # # #     # # #     #   # #         # #
# ##### ##### ##### # # ### # # ### ######### ######### ### ##### ### ### # ### #
#   # #     #   #   # # #   # # #   #     #   #     #   #     #     # #   #     #
### # # ##### ######### ##### # ####### ### ### ######### ########### ####### ###
#   # # #         #       #   #   #   # #       #           #             # # # #
### # ##### ######################### # # ####### ### # ### ### ####### # # # # #
#     #   #       #   #   # #     #   #   #   # # #   # #       #       #   #   #
##### ### # # # ### ##### # ### ### ##### # # # # ### ### ####### ##### ### # # #
#       #   # #           #                 # #   #     #   #         # #   # # #
##################################################################### ###########

