############################################################### #################
#   # # #         #   #   # # # #         # # # #     #                   # #   #
### # # ####### ### ##### # # # # ### # ### # # ##### ### ######### ####### # ###
#   #   #                 # #     #   #           # # # #       # # #   #       #
### # ### ### ########### # ### ############### ### # # # # # ### ### ### # #####
#       # # # #               # # # # #         #         # # #       # # #     #
##### ##### ### # # ######### ### # # ### # ### ##### ######### ####### ### #####
# # #       # # # # #   # # #     # # #   #   #       # # # #       #           #
# # ####### # ####### # # # ##### # # ### ########### # # # # ####### ##### # # #
#     #     #   #     #   #       # # # # #   #     #                   #   # # #
##### # # # ### ####### ##### ### # # # ##### ##### # # ### # ### # ######### # #
# #   # # # #     # # #       #                       # #   # #   # #   #   # # #
# ### # ### ### ### # ##### ##### ### # ####### # # # ##### ######### ##### ### #
# #   # # #     #   # # # # # #   #   #   # #   # # # #   #               # # # #
# ### ### ##### # ### # # ### ### ### ##### ### ##### # ### # ### ### # # # # ###
# # # #         #   #     # # #     # #         #         # # #   # # # #       #
# # # # ### # # ### # ### # # ####### # # ### ### # # ##### ### ### #############
#     #   # # #       #         # #   # # #   # # # # #       #         #       #
# # # ##### # # # ####### ##### # ### ######### ### # ### # # # ### # ### # #####
# # #       # # # # #     # # #         #   #       #   # # # # #   #     # # # #
# ### # ########### # # ### # # ##### # ### ##### # ##### # ### # ### # # # # # #
# #   # # #   # #   # #   #       #   # # # # #   # # # # # #   # # # # # # #   #
# ### ### ### # # ### ##### # ####### ### # # ### ### # # ####### # # ######### #
#   # #               #   # # #         #   # # #   #     #   #   #             #
# ### ####### ### ####### ########### ### ### # # ### # ### ####### # # ### # # #
# #     #       # #   # #   #   #       # #         # #       # # # # #   # # # #
##### ##### # # ##### # # ##### ######### ####### # ### # # # # # ##### ####### #
#   # #     # # #   # #     #     # # #     # # # #   # # # #       #         # #
### # ############# # ### ### ### # # ##### # # # ##### ### # ############# # ###
#       #   #           #   # # #   # # #             # #   #   # # # # # # #   #
########### # # # ##### # ##### # ### # ### ##### # ####### ##### # # # # #######
# #     #     # # #       # #   #           # #   #   # #     # #               #
# ### ##### # ####### ### # ### # ### # ### # ### # ### # # # # ### # # # #######
#         # # # # #   # # #       #   # #     #   # #   # # #     # # # #   #   #
# # # ### ##### # # ### # # # ### ### # ### ##### ##### ### # # ### ##### ##### #
# # #   # #         #   #   # #     # #   #   #   #       # # #         # # # # #
# # # ### # ####### ### # # ##### ### ##### # ### # # ### ##### # # ####### # # #
# # # # #     #       #   # #     #     # # # #     # #       # # #         #   #
####### # # ##### ####### ##### # # ##### ####### # # ### # # ##### # ### # ### #
#         # #     # #     #     # # #             # # #   # #   #   # # # #     #
##### # # # # ### # ##### ##### # ### # ### ### # ### ##### ##### ##### ##### # #
#     # # # # #   #   #   #     # #   # # # #   # #   #     #     # #       # # #
##### ### ### # ##### # # ##### # ##### # # ##### ### ##### ##### # ### # ### # #
#     #   #   #   #     # #     # #     #     #     #   # # #           # #   # #
# ### ### ### # ##### # ##### # ### # # ######### ### ### # ##### ##### # ### # #
# # #   # #   # # #   #   #   # #   # # # #         # #     #   #   #   #   # # #
### # ### ### ### ##### ##### ##### ### # # ##### # ####### ### # ###############
# # #   #   #   #       #         # #     # #     #     #   # #         # # #   #
# # # # ##### ##### # # ##### # ##### ### ### ### ### # ### # # # ### ### # # ###
# #   #   #     #   # # # #   # #       #   #   # #   # #     # # #     #       #
# # ### ##### # ### ### # # ####### # ####### ##### # ### ##### ### ### # # # # #
#   # #   #   # # #   # #   #   #   # #       #     #   #   #     # #     # # # #
### # ########### ##### ####### ##### # # # ### ### ########### # ##### ####### #
# # #     #   #         #             # # # #   #         #     #   #   # #   # #
# # # ### ### # ####### # # ### ### # ##### ##### ##### ##### # # # ### # ### # #
#   # #           #     # # #   #   #   #     #     #   #     # # #   #       # #
################################### #############################################

