################################################### #############################
#       # #     #     #   #   # # #   # #     #         #     #   # #   #       #
# ##### # # ##### ##### ### ### # # # # ### ##### ### ### ##### ### ### # #######
#     #   #             #     #   # # # #   #     #   #   #     #   #       # # #
######### # ##### # ### # ####### # ### # # ##### ####### # ##### ##### ##### # #
#       #     # # #   #   #       #   #   #   # #     #     # #       # # #     #
### ### # # ### # ##### ##### # ### ### ####### # ##### ##### # ####### # # #####
#     #   #     #     #       # #   #   #   # # #             #   #             #
####### # ### ############### ##### ### # ### # # ### # # ### # ### ### ##### ###
# #   # # #     #   #   #   # # # #   #     #   # # # # #   #     # #   #   #   #
# ### ####### ##### # # # # ### # # ### ##### ### # ######### # ####### ### ### #
#   # # #   #   #     # # # # #     #   # #             #   # #   #           # #
# ### # # ### ### ####### ### # ####### # ### # ### # ##### ####### ##### ##### #
# #   # #     #   # #       #     # #   #     # # # # #   #   #   #     #   # # #
# ### # ##### # ### ### ##### ##### ### ### # ### ##### ### ##### # # ####### # #
# # #     #               # #     #   #   # #           #           #         # #
# # # # ##### # ########### # ####### # ### ### # # ##### ### # # # ##### ### # #
# #   # # # # #       #     #   #   #   # # #   # # #       # # # #     #   # # #
# ### ### # ### ##### ### ### ##### # ### # ### ### # # ########### # ### # #####
# # #     #     # # # # #   #               # # #     # #         # # # # #   # #
# # # ##### ### # # ### # ### ##### # # # ### ####### ##### # ######### # # ### #
# #     # # # #               # #   # # # # # # # #     #   #       # # # # #   #
# # # ### ### # ############# # ### # ##### # # # ######### ######### # ### ### #
#   #   # # # # #   # # # # #   #   # # #           #   #       #     # # # # # #
### ##### # # # ### # # # # # ####### # ### ########### # # # ### ##### # ### # #
#   #           #   #       #       # #   #   # #     #   # #             #     #
### ##### # ### # ### ### ##### ######### # # # ### ##### # ### # # # ####### ###
#     # # # # #     #   #     # # #   # #   #           # # # # # # #       #   #
### ### ##### # ##### ####### ### # ### # # # ########### ### # ### ######### # #
# # # # # #                 # #       #   # #                 #   # # #   #   # #
# # # # # ##### # ##### ### ####### ### # ##### ####### ### # ####### ### ### ###
# #   #   # #   #     #   #   #         # #   #       # # # #         #   #     #
# # ##### # ### ############### ##### ##### ############# ########### ### ### ###
# # # # # # #       #       # # # # #                 #     # # #   # #   #     #
# # # # # # # ##### # ####### ### # ### # ##### ### # # ### # # # ####### # ### #
#       #   # #   #   #   #       # # # # #   #   # #     # # #     # #       # #
##### ### ### ### ####### ### # ### # # ### ########### ##### ### ### # #########
# #   #         #       #     # # # #       #     # # # #                   # # #
# ### ### ####### ##### # ####### # # ####### ##### # ### # ### ####### ##### # #
#   # # #         #   # # #   #   #     #                 #   #     #         # #
### # # # ####### ### ### # ##### # ### # # # ### ### ### ####### # # # ##### # #
#             # #                     #   # #   #   #   # # #   # # # #     #   #
####### # # # # ### ##### ### ##### # # # ########### ##### # ######### # # # # #
# #   # # # #     #     # # # # # # # # #       # # # #   #   #       # # # # # #
# ### # ##### # # ### ### # # # # # ####### ### # # ### ### ##### ##### ##### # #
#       #     # # #     # #       # #         #           #   #   # # # # #   # #
# ### # ### # ### # ##### # # # ### ####### ### # # ### ### ### ### # ### ### # #
# # # # #   # #   # #     # # # #         #   # # #   #                     # # #
### # ### ### ### # ##### ############# # # ### ### # # # ### # # ### # # #######
# #     # #     # # #       #     #   # # #   #   # # # #   # # # # # # #   #   #
# # ### ####### ######### ##### ### # ##### ##### ### # ### ##### # # ####### ###
#   #       #           #           # #   #     #   # #   #   # #   #           #
# # # # ##### ### # ####### ### # ### # # # ########### # # ### ####### # # #####
# # # #     #   # #       #   # # #     # #         #   # # #     #   # # # #   #
# # ##### ### # # ##### ####### ### ### ### ### # ### # ### # ####### # ####### #
# # #       # # # #           #   # #     #   # # #   #   #           #         #
############################################################################### #

