####################################################### #########################
# # #                   #   #   #         #   #   #     #               #     # #
# # # # ### # ### ##### ### # ### # ######### # ####### # ######### ##### ##### #
#     # #   # # #   #         #   #         #   #   #           # # # #     #   #
# ### ######### # # ##### # ####### ### # # ### # ### ### # ### # ### ### ### # #
# # # #   # #     # # #   #   # # #   # # # # # # # # #   # #       # #       # #
### ### ### ### ##### ####### # # # ######### # # # ##### # # ### # # ### # #####
#     # #     # #   #   # # # #         #   #             # # # # # #     #     #
### ### ##### ##### # # # # # # ### # ##### ### ### ##### ##### # # # ### # #####
# #     #     #     # #           # #     # #   #       #       # #   #   #     #
# ##### ##### ##### ### # ##### # # # # ### ### ### ##### ### ##### # ### ### ###
#   #   # #     #     # # # #   # # # #           #   #   #     #   # # #   # # #
# ##### # ### ##### ##### # # ### ##### # # # # ######### ### ### # # # # ### # #
#                   #     #   #   #     # # # # # #     #   #   # # # #   #     #
### ### # # ####### ### ### ##### ### ### # # ### # ### # ### ########### ### # #
#     # # # #         # # #   #   # # #   # #         # # #         #   #   # # #
############### # ### # # # ##### # # # ### ### # ### ### ##### # ##### # ### # #
# # #   #   # # # #       # #       # #   #   # #   # #   # #   #       #   # # #
# # ### ### # ######### ##### ### # ### ### # ### # # ### # ##### # ### ### ### #
#     #   #             #     #   #   #   # #   # # #   # #       # # #   # #   #
# # # # ##### # ### # # ### ##### ### # ### ############# ##### # ### ##### ### #
# # #     # # # #   # # # # #       # # #   # #     #   #   #   # #     #     # #
# ##### # # # # ##### ### ### ### ######### # # ##### # ### ##### # # ####### ###
#   #   #     # #       #       #   # # #     #   #   # # # #       #     #     #
# ########### ##### # ####### ##### # # ##### # # # # ### # ### # # ##### # # # #
#   #           #   #     #     #         #     #   #     # #   # #     # # # # #
# ######### # ####### ####### # # ### # # ### # ### ##### ### # ### # # ####### #
# # # #   # #   # #       # # # # #   # # #   # #       # # # #   # # #   #     #
### # ### ### ### # # # # # # # ### ##### ### ##### ### ### ### # ### # # ##### #
#             #     # # #   # # #   #       #     #   #   #     #   # # #   #   #
# ##### ### # # # # # # # ##### ##### # # ### ##### # ######### # # ### ####### #
# #       # # # # # # # #   # #   # # # #   #     # #   # #     # #   #     #   #
# ### # ### ##### # ##### # # # # # ##### ### ########### ####### # ########### #
# #   # #     #   # #   # # #   #   #   #   #     # # #     #   # #       #     #
##### ### ####### ##### # # # # # ##### # ### # # # # # ####### ############### #
#     # #   #   #       # # # # #     #   #   # # # #     #   #   # # #   #     #
# # ### # ##### # ##### # # ##### ##### # ### # # # # ##### ### ### # # ##### ###
# # # #     #       # # # #   #   #     #   # # #                           #   #
##### # # ####### ### # ### # ### ### # ####### ####### # # # # # # # ##### # ###
#       # # #       # #   # # #     # #     #       #   # # # # # # # #   # # # #
##### ##### ### # ### # ### ##### ##### # ##### # # ######### ####### # ####### #
#     # #   #   # #       #   # # #     #     # # #       # #   # #         #   #
### # # ### ### # ### # # ### # ##### ### ##### # # ##### # ### # # ### ##### ###
# # # #         # #   # #   # # #       # #     # # # # # # #   #     #       # #
# # ############# ### # ####### ### # # ##### ##### # # ### # ##### ##### ### # #
#   #       #     # # #           # # #   #   # #         # # # # # #       # # #
### ### # ### ##### # ### # ######### ### ### # ### # # ### ### # ##### # # # # #
#   #   # # #   #       # # #           # #     #   # # # #       # # # # # #   #
### ### # # # ##### # # # # # ### ### ### # # # # ### # # # ### ### # ### ### ###
#     # #         # # # # # # #   #     # # # # # #   #       #         # #     #
######### ### # ##### ### ####### ##### # ### ### # ####### # ### ### # # # # # #
#           # #     # #     #       #   #   #   # #     #   # #     # # # # # # #
# ##### ####### # ### ### ####### ##### ### # ##### # ### ### # ### ####### # # #
#   # # #       # #   #   #         #     # #   # # # #   #   #   #     #   # # #
##### # ### # # ##### ##### # # ####### ######### # ##### ### ### # # # ### ### #
#       #   # # #       #   # #   #         #         #   #     # # # #   # #   #
####################################################################### #########

