########################### #####################################################
#   #   # #               # #             #     # #   # #   #         #   #     #
# ### ### # ##### ##### ### ########### ##### ### # ### ### ##### ##### ##### ###
#           # #     #   #     #   # # #     # #         # #   #   #   # #       #
# ### ####### ######### # # ##### # # ### ### # ####### # ### ### ### # ##### # #
#   # # # # # # # #   # # #           #     # # # #   #     #           # #   # #
# ### # # # # # # ### # ##### ### ### ### ### ### ### # ### ########### # ### ###
# #   # # #         # # # #   # # #         # #       # # # # #   #     # #   # #
### ### # ####### ### # # ##### ####### ##### ##### ##### # # ### ##### # ### # #
#     # #           #     #   # #   # # #   # #       #     #   # #     #       #
####### ### ### ### ### ##### # ### # # ### # ##### ####### ### # ##### ### #####
#     # # #   # #         #   #   # # #   #   # #     # #   # # #       #     # #
##### # # # # # ####### ##### ### # # # ### ### ### ### # ### # ##### ##### ### #
#       #   # #   # # #     #   #       # # # #             #   #   #   # #   # #
##### # ### ### ### # ### ##### # ##### # # # ### # # ### ##### # # # ### # # # #
#   # #     #   # #       # #     #       #   # # # # # #   # # # #         # # #
### # # ######### ####### # ####### ##### # ### ### ### # ### # ### # # ### ### #
#   # # #   # # # #   #               # #           #         # #   # # #   #   #
### ### # # # # # ### ### # ########### ### # # ########### # # ### ####### ### #
#     # # #       # #     # # # #   # #   # # # # #     #   # #   # #     #     #
# ######### ##### # ##### ### # ### # # ### ##### ##### ##### ### ####### # # # #
# #     #   #   #     # # # # # #           #                 # #   # #   # # # #
# # ####### # # # # ### ### # # # ####### ############# ##### # # # # ### # # ###
# #   #     # #   #         # #   #         #     # #   # #     # # #     # #   #
# # ### ####### # ####### # # # # ##### ### # ### # ### # # # # ### # ### # # # #
#     # #       # # # # # #     # #     # # # #           # # #     # #     # # #
# ################# # # ####### ######### ### ### ### ######### # # ##### #######
# #     #   #   # #         #   # # #     # #   # #     #       # #   #     #   #
# # # ### ##### # # # ##### ##### # # ### # ##### ### # ####### ##### ### ### ###
# # # # #     # #   # #   # # # # # # #           # # # # #     #               #
# # ### ### ### ### ##### # # # # # ### # # ####### ##### # ######### ##### # ###
#       #   # # # # #                 # # # #     # # # #     #   # #   #   #   #
# ### ##### # # # ### # ### # # # ### ##### ### # # # # # ####### # ### ### #####
# #     # #   # #   # # #   # # # #       # #   # #     # # # # # #       #   # #
##### # # # ### # ####### # ########### # ####### ##### ### # # # ##### # # # # #
#   # # # # # #   # # # # #   #     # # #   #       #       # # # #     # # #   #
# ##### # # # ### # # # # # # ##### # ### ##### ### # ##### # # # ### ### # ### #
#                 #       # # #         #     # #     #               # # # #   #
### ##### ##### # # ####### ### ### ### # # ##### ### # ##### ##### # # # # #####
#   #     #   # #   # # # #   # #     # # # #       # # # #   # #   #   # #     #
##### ####### ####### # # ##### # # # ### ### ########### ##### ##### ### #######
# # # #       #   # #   # #     # # #   # # # #     #   #     #     #   # #     #
# # ######### ### # ### # ########### ### # ##### ##### ##### # # # # ##### ### #
# #   #                         #   #             #   #     #   # #         # # #
# ### # # ### ### ##### # ##### ### ### ##### ### ### # ####### ### # # # # # ###
#       # #   #   #     # #   # #       # #   #     #             # # # # #   # #
### ### ### # # # # # # ##### # ### ##### ######### ##### ##### ### ### ### ### #
# # #     # # # # # # # # # #     # # # #                   #     # #   #       #
# ### ########### ####### # ### ##### # ### # ####### # ### ### ### ####### ### #
#     #   # # #   # # #                     # #       # # # #     # #       #   #
##### ### # # # ### # ##### # # ##### ##### # ### ##### # ##### # # ### ####### #
# #   #     #   #           # # # #   #     # #   #       # #   # # #   #       #
# ####### # ####### ##### ##### # ####### # ##### ##### ### ### ### ##### ### # #
# #     # #           #   #           #   # #       #   # #       # #     #   # #
# ### ##### ### ### ### # # # # ### ### ##### ########### # # # ####### ####### #
#             # #     # # # # # #   #     #   #             # #   #       #     #
##### ###########################################################################

