############# ###################################################################
#       #     #       # #   # #     #               #   # # # # #       #   #   #
### ######### # # # ### # ### ##### ### ############# ### # # # # # ##### ### ###
# # #   # #   # # # # #   #     #   #   # # # #     #             # #       #   #
# # # ### # # ### ### # # ### ##### ### # # # # ##### ########### ### # ##### ###
# #       # #     # #   # # # # #   #     #   # # #             # #   # #   #   #
# ##### ######### # # ##### # # ### # ##### ### # ### # # ### ##### ### # ### ###
#   #     # # #   #   #   #     #     #   # # #   #   # # #   #     # # # #     #
# ### # ### # ### ### ### ##### ### ### ### # # ##### ########### ### ### ### ###
#     # # #       #     # # # #         #   # # # # #       # #     #       #   #
# ####### # ##### # ##### # # ### ### ##### # # # # # ####### ### ### ######### #
# # # #   # # # # # #     #   #   #   # #         #   #     #         #     # # #
# # # # # ### # # # # ##### ### ####### # ######### ### ##### # # ##### # ### # #
#     # #     #     #   #   #           #   #         # # # # # #       #   # # #
### ####### ##### ### # ### ### ######### ### ### # ### # # # ######### ##### # #
# #   # #     # # #   # #   #   #     # #       # # #             # #     # # # #
# # ### # ##### # # ##### # ### # # ### # # ####### # # ##### # # # ####### # # #
# # #     # #       #   # # # # # # # # # # # # # #   #   # # # #     #   # #   #
# # ##### # # # # ### # ### # # # ### # # ### # # ######### ### ### ### ### # # #
# # #     # # # #     # #   #               # #         # #   # # # #     # # # #
# # ##### # ####### # ##### # ### ##### ##### # ### # ### # ##### ### ##### ### #
#     # #   #   # # #   #       # #   #   #   # # # #         #   #   # # # #   #
# ##### ### ### # ### ##### # ##### ######### # # ############### ### # # # # ###
#       #   # #     # #   # # #       #             #   #   # # # #     # #     #
####### ### # ### ### # ### ### ########### ######### ### ### # # # # ### # #####
#         #   #   #         #   # #     # #   #                     # #       # #
####### ##### ### ##### ##### ### ### ### # ### ### # # # ##### # # ### ####### #
#     #     # # #   #     # # #       #   #       # # # #   # # # # # #         #
# ####### ### # # ##### ### # ### ####### # ######### ### ### ####### # ##### ###
#   # # # # #   #               #   #         #     # #   #         #       # # #
# # # # # # ### # ##### ### ##### ####### # ### ####### ##### ####### ######### #
# # # # # # #   # #       # #     #     # #   #     # # # #       #         #   #
### # # # # ### ####### ##### ### ### # # ##### ##### ### # # ##### ########### #
# #               # # #   #     # #   # # #             #   #         #     #   #
# ### # ####### ### # # ##### ##### ##### # ############# ### ##### ### # ##### #
#   # # #   #   #     # #   #     #   # # # #   #           #   #     # # #     #
### # ##### ### ##### # # ##### ### # # # # # ### ########### ### ##### ### # # #
#         # #   #   #   # #   #   # # #     #               #   #   # #     # # #
### ####### ### ### ### # ### # ##### # # ### # ################# ### # # # #####
#     #           #       # #   # #     #     #     #       #   # # # # # # # # #
# # ##### # ### # ### ### # # ### # ### ############### ##### ##### # # ##### # #
# # #     # # # #     #         #     #         #   #               # #         #
# ### ####### ### ####### ##### ### ### ### ##### ##### ### # # ##### # #########
#   # #             #     #   #       # # #           #   # # #         #     # #
# ########### ############# # # ######### ##### ####### ######### ##### # ##### #
# #     #     #   #         #     #           # # # #         # #   # #     # # #
### ### ### # ### ####### # # ### ### ##### ##### # # # # # # # ##### ####### # #
# #   #   # # #           # #   #         #           # # # #     #     #       #
# ####### ####### # # ### ####### # ### ####### # ##### # ########### ##### #####
#     # # #       # # # # #       # #         # # #     # #   #   # #   #       #
##### # # ##### ### ### # ### ### ##### ### # ############### # ### # ##### # ###
#   #           #     #   #   #   #     #   #   # #   # #           # # #   #   #
# # # ######### # ##### ##### ### ### ### ##### # ### # # ########### # ### ### #
# #   #         #   # #   #     #   # # #   #                                 # #
### ### # ### ### ### ### ######### ### # # # # ### # ### ### ##### # ### # # ###
#   #   # #   #     #       #       #     # # # #   # #   #   #     #   # # #   #
########################################### #####################################

