######### #######################################################################
#       #       #     # # #     #   # #       # #   # # # #       # # #         #
# # # ### ####### ##### # # ##### ### # ####### # ### # # # ### ### # ### ### # #
# # #   #     #   #     #     # #           #                 #         # # # # #
##### ### # # # ##### ### ##### # # # # ##### # # ############# # # # ### # #####
# #     # # # # # # #   # #       # # #   #   # #   #   #   # # # # #     #   # #
# # # # ### ### # # # ### ### ####### ####### ##### # # # ### # # ##### # # ### #
#   # #       # #                   #   #   #   # # # #     # # #   #   #       #
### ##### ##### ### # ##### ### # # ##### ### ### ##### ##### ########### ##### #
# # #         #   # #   #     # # #     #   #                   #     #     #   #
# ####### ##### ##### ######### ######### ### # # # # # ### # # # # ##### ### # #
# #     # # # #   #     # #   # #     # #     # # # # #   # # #   #     #   # # #
# ##### # # # # ### ##### # ####### ### # ##### ####### ### # ### ##### # # # # #
# #   # #           # # #                   #       # #   # #   #     # # # # # #
# # ### # ### ### ### # # ### ### ### ############# # ################### ##### #
#         # #   #         #   #   #             # # # # # #         # # # #   # #
### ##### # # # # # ########### # # ### ######### ### # # # ######### # ##### ###
#   # #     # # # #     #   #   # # #     # #   # # # # #     #     #     #     #
# ### ### # # ##### ### ### ########### ### # ### # # # ### ### # ### ##### #####
# #       # #   #   # #     #   #   #         #         # #     # # #           #
### ### ### # ##### # # # ### ### # ### # # ##### # ##### # # ##### # # # #######
#     # #   #     # #   # #       # #   # #       #         # # #     # #     # #
### ### ### ### ### ### ### # ########### # ### # ##### ####### # ####### ##### #
#   #   #   #   #     # # # #     # #     #   # # #                   # #       #
### ##### ##### # ### ### # ####### # ### ### # ##### ### ### ######### # ### # #
#     #   #     # #             #   # # # # # # #   # #   # #       #   # #   # #
# # ####### # # ### ### ##### ##### ### ### ### # ####### # # ### ### ###########
# #   #     # # #   #       #   # #           # # # #       #   #             # #
### ### ##### ### # # # ### # ### # # ########### # ### # ##### ##### ######### #
#   # # #   # #   # # # #   #       #   # # #   # #   # #     #   #     # # #   #
### # ##### ### # ### # # # # # ### ##### # # ### # ####### ### # # # ### # # ###
# #     #       #   # # # # # #   #   #           #     #     # # # #           #
# # ### ### ### # # ##### # # # ### ### ### # ### ### ##### ##### ######### #####
#   #     # #   # #     # # # #   #     # # # #         # #     #   # #   # #   #
### ####### ####### # # ####### ### ### # ####### ### ### ######### # # ##### # #
# #     # #     #   # #       # #   #           # #               #           # #
# # ##### ######### ### ##### ### ####### ### # ####### # ### ### # # # # ### # #
#             #     #     #     # #       # # #       # # # # #   # # # #   # # #
### ### ####### # # ### # ### # ######### # # ############# ##### ##### # #######
#     # # #   # # # # # # #   #       #     #           # # #   #   #   #     # #
##### # # # ####### # # ##### # ### # ### ### ### # # ### # # ### # ### ### # # #
#     #         #   #       # #   # # #   # # #   # #         # # #   #   # #   #
# ### # ####### ####### ##### # ### # ### # # ### # ##### ##### # ### ####### ###
# #   #   #       #   #   #   #   # # # #   #   # # #   #       #   #     #     #
##### # ### ### ### ### ### # # # # # # ### ### # ### ####### ### ######### # ###
#     # # #   #       # # # # # # # #   #     # #           # #   #   #   # #   #
# ### ### # ##### # ### # ### ### # # ##### ### # ##### # # ##### ### ### # #####
#   #   #     #   # #     #   #   # # #   # #   #     # # # # #           #   # #
##### ##### ### # ##### # ### ####### # ##### # # ### ####### ### # ### ##### # #
#     #   # # # #     # #   #   #           # # #   #     #   # # #   # #       #
### # ### ### ### # # ### # # ### # ### ####### # # # # # # ### # ### # # ### ###
#   #   #         # #   # # #   # # #     #   # # # # # #       # # # # # #     #
### ##### ##### ##### ##### ##### ##### ### # # # ########### # ### ### ### ### #
# # # # # # #     #       #   #     #   #   #   #       #   # #       #   # # # #
# # # # ### # # # ### ##### # ### # ### ##### # # # # ### # # # # ### # # ### ###
#   #         # # #       # #   # #   # #     # # # #     # # # # #   # #       #
######################################################### #######################

