####################################################################### #########
#     #   # #       #     # # #                   #     # #   #       #     # # #
# # ##### # # ### ##### ### # ### ### ### # ######### ### ### ### ### ### ### # #
# # #     #     # # #   # #         #   # # # #           #     #   # # # #     #
# ####### ### # ### ### # # ################# # ### ### ##### ### # ### # ##### #
#   # # # #   #                                   # # # #   #   # #   #   #     #
# ### # # ##### ### # ### ##### ##### # ##### ####### ### ### ### ####### ### ###
# #       #   # # # #   #   # #   #   # # # #     #   # #       # #   # #       #
# ####### ### # # ####### ### ### ####### # # # ##### # ### # ### # ### # #######
#   #   #   #       # # # #   # # #   #   # # # #     # #   # # #   #           #
# ### ### ### ### ### # ##### # # ### # ### ######### # ### ### # ### ##### # # #
# # #     # # #   #   # # #     # #           #   #   #   # # # #   #     # # # #
# # ### ### # ##### ### # # ### ### # # ####### ### ### ### # # # ### ##### #####
#   #     #   # # #         # # #   # #   # # #     # # #             #   # #   #
# ####### ### # # # ######### ### ######### # ##### # # # ##### # # # # ####### #
#   # # #   #           #     #   #   #   #   # #     # # #   # # # #     #   # #
# ### # # ### ##### ##### ##### ### ### ### ### # # ### # # ####### ### ### ### #
# #   #         # #         #     #       #     # # # #           # # # # #     #
# # ##### # ##### ##### ####### ### ####### ####### # # ##### # ##### ### # # # #
#       # # #         # #     # # #   #     # # #         #   # #           # # #
##### ##### ### ##### ### ##### # # ##### ### # ### # # ######### # ### #########
# #       #         #       # #           #         # #     # # # # # #         #
# ##### ##### ##### ##### ### # ### ####### ### # # ##### ### # # ### # ### ### #
#       # # #   #   # # #   #   # # # #       # # # #   # #   #       #   #   # #
### # ### # # ####### # ##### ### ### ### ############# ### ### # ### ##### #####
# # # #         #     # # # #   #   #   # #     #   # #   #   # # #     # # # # #
# ### ####### ##### ### # # # ### ### ### # ##### ### # ### ##### ####### ### # #
#   #   # #   # #     #                   #               #   #   #     # # #   #
### # ### # # # # ##### ####### # ######### ### # ######### ### ####### # # ### #
#     #   # # #           # #   #             # #   # #   #   # # #   #   #   # #
### ### ##### # ########### ####### ##### # ######### ### # ### # # ### ### ### #
#   #   # # # #     #       #   # #     # # # # # #   # #               #       #
### # ### # # # # # ### # ##### # # ######### # # # ### # # ##### ####### ##### #
# #     # #     # #     #         # # #       #           #   #         # #   # #
# # ##### ### ############# ######### ### ##### # ##### ### ##### # ##### # # ###
#     #     #     # # #       #     #   #       # #       #     # # # # #   #   #
# ### # ##### ##### # ####### # ##### ### # ####### ##### # ##### # # # # # ### #
# #           # # # #     #               #     # # # #   #   #   #       #   # #
##### # ####### # # # # # ### # # # # ### # ##### ### ##### ### # # # ### ##### #
# # # # #             # # #   # # # # #   #               # # # # # # #       # #
# # ### # ### # ##### ### # # ### # # ### ### # ### ##### ### # ### # # # # #####
#   # #   # # # #       # # # #   # # #     # #   #   #       #   # # # # #   # #
# ### # ### ######### ########### ### ### # ### ### ##### ##### ##### ##### # # #
#           #     #       #   #     #   # #   # #   #       # #   # # #   # #   #
####### # # # # ####### # # # ### # ##### # ### ### # ### # # ##### ### ####### #
#       # #   #       # #   #   # #   # # #   # #   # # # #                   # #
### # ### ########### # ### ### ### # # # ####### ##### ### ### ### ### # ### # #
#   # #       #     # #   #   # # # #   #   # # #   #     # #     # #   # #   # #
# # # ##### # ### ############### ########### # ####### ####### # # ### ### # ###
# # # #     # # #   #     # # # # # #     #     # # #         # # #   #   # # # #
# # ##### # ### # ##### ### # # # # # ##### # ### # ### ### ##### # ### ####### #
# # #     #               #               # # #   #       #     # # # # #       #
# ##### # ### # # # ### ### ### # ### # # # ##### ### # ### ####### # ### #######
# # #   # #   # # # #         # # # # # #             #   #   #           #     #
# # ##### ##### # ##### ### ### # # # ### ### ####### # # ##### # # ### ### #####
#   #       #   #     #   # #   #   # #   #         # # #     # # # #           #
##################################### ###########################################

