####################################### #########################################
#         #     # #   #         # # #   # #   #   #         #       # #   #   # #
### ### ### ### # # ##### # ### # # # ### # ### ####### # # ### # ### # ### # # #
# #   # # # #       #   # # # # #   #   #           # # # #   # #       # # #   #
# # ### # ##### ####### # ### ##### # ######### ##### ### ##### ######### ### # #
#     #       # # #       #   #   #       # # # # #   # #     #   #           # #
# ### # ### ### # # ##### # # # ####### ### # # # ### # ### ### ##### ### # ### #
#   # # # # # #   # #     # #       #   # # # # # # #   #       #       # # #   #
# ##### # # # # ####### # ##### ####### # # # # # # # ##### ##### ###############
#   #     #   #   # # # #     #   #       # #   #   # #       # # #   # # #   # #
# ######### # # ### # ### # ### ####### ### # ### # # # ##### # # # ### # # ### #
# # #     # #   # #   #   # #     # #   #   #   # #   #     # # #   #   #   #   #
### ### ####### # # ### ##### ##### ### ### # ##### ### ### ### # ### ### ### ###
#   # #   # #     #   # # # # #   #   #     #   #   #   # # #   #   # # #       #
### # ### # ### ##### # # # # # # ### ##### # ##### # # # ### ##### # # # #######
# # # #       #   #   #     # # # #   # # #     #   # #     #               #   #
# # # ##### ### ##### # ##### ### ### # # ### ### ##### ##### # ### ### ####### #
# # #     # # #   # #     #   #   #   #   # #     #   # #   # #   #   #   #   # #
# # ### # # # # ### # ####### # ##### ### # # # # ### # ### ### ########### ### #
#       #   #   #     #     #   # # #   #     # # #           #   #   #         #
### ####### ### ### # # ####### # # # ### # ########### ### ### ##### # ##### # #
# # #         # # # #   #   #         # # # # # # #   #   # #   #       #   # # #
# ########### # # ##### # ### ### # # # ### # # # ### # ####### # ### ### #######
# #       # # # #   # #   # # #   # # #   #   #   # #         #     #           #
# # ##### # # # ### # # ### # ######### # # ### # # # ############# ######### ###
# #   # #   # # #   # #     # #   # # # #   #   # # #         #         #   # # #
# ##### # ### # # ### # ##### # ### # ### ##### ### # ### # ####### # ##### ### #
# # #   # #       # #   # # # #     #       # # #       # #   #     # # #       #
# # # ### ####### # ### # # # # ######### # # # ### ############### ### ### # ###
#       #   # #     #     #         # #   # #     #   #   #     #   # # #   # # #
##### ### ### ### ####### ####### ### ### ##### ### ### ### # # # # # # # ##### #
# # #     # # # #   #       # #       # #   #     #     #   # # # #     #     # #
# # # # # # # # # ####### ### ### ### # # ##### ### ##### # ######### ### ##### #
#   # # #       # #         #   #   #   # # #       #     # # #     # #       # #
### ####### # ### ####### ### ### ####### # ### ####### ##### # # # # ### ##### #
#   #       # #   # # #     # #   #   #     #     #   #   #     # # # #         #
### ### ### ##### # # ### ### ### # ##### ### # ### ### ##### ##### # ### # # ###
#         # #   #   # # # #   # #   # #     # #       #       # # # # # # # # # #
##### ##### # ### ### # # ### # # # # ### # ####### ### ####### # ### # # # ### #
#   # #       #                   # #   # #   #   #                       #     #
### ######### # ####### ### ##### # # ##### ### ### ### ### ########### # ##### #
# # #     # #   #         # #   # # # # #     #       # # #         # # #     # #
# # ### ### ### ##### # ### ### # ### # # ### ##### ##### # ### # ### ### #######
#   # #           # # #   # #   # #   #     # #           # # # # #     # # #   #
### # ########### # # ### ##### # # ### ######### ### ####### ##### ####### # ###
#           #     #   #   #             #   # # #   # #       # #         #     #
##### # ### ####### ################# # ### # # # # ### ### # # ### ##### # ### #
# # # #   #       # # # #       # #   #           #       # # # #       #   #   #
# # ### # ####### ### # ####### # # ##### # ### # # # ### ##### ### ### ##### ###
# #     # #     #       # #           #   #   # # # # #       #       # # # # # #
# ### ### ### # ### ### # ##### ### ####### ### # # # ### ##### # ### ### # ### #
#       # # # #       # # # #   #       #     # # # #   # #   # # #           # #
### ### ### ########### # # # ##### # # ### ### # ### ### # ### ####### ### ### #
# #   #   #     #             #     # # #     # #   # # #     #     #   # #     #
# # # ##### ### # ######### ####### # ##### ### # # ### # # ### ### ##### # #####
#   #   #     #     #       #       # #     #   # # #     #       #     #       #
##################### ###########################################################

