######################### #######################################################
#   # # # #   #         # #     # #   #   #   #   # # #   #               # #   #
### # # # ### ##### ##### # ##### # ### ### ##### # # ### ### ##### ####### # # #
# # # # # # #         #       #                 # #       # # #   #           # #
# # # # # # ### ##### ### ##### # ####### # ##### ### ### # # # ##### # #########
# #   #           # #     #     #   # #   # #   #   #   #         # # #   # # # #
# # ##### ######### ### ####### ##### ##### ### # # ##### ### ##### ####### # # #
#       # #   # #       # # # #           # # # # # # #   # #                   #
##### ####### # ### # # # # # # # # ##### ### # # ### ##### # ##### # ###########
# # #   # #     # # # #       # # # # # # # # #   # # #           # #   # #   # #
# # # ### # ##### ##### ####### ##### # ### # ### # # # ### ##### ### ### # ### #
# #       # # # # # #     # #       #       #   #   # # #   # #   # #   #       #
# ### # ### # # # # ### ### # ######### # ### ### ### ##### # ##### ##### #######
#   # #   # # # #   #           #     # #     # # #       #                     #
# ### ##### # # # ####### ####### ######### ### # # ####### ####### # # # ### ###
# #   # # #       #   # #     #       #     # # #   # # #         # # # #   #   #
# # ### # ### # ### ### # ##### ####### ##### # # # # # ### ### # # # # ####### #
# #     #   # # #     # # #             #   # # # # #   # #   # # # # #       # #
# # ##### ### ##### ### # # ##### # ####### # # # ### ### # ####### # # ### # ###
#       #     # # # #   #   #   # # # #                         # # # # #   #   #
# ##### # # ### # # ### ### ### # ### # ##### ### ### # ### ##### ######### ### #
#     # # # #   # # #   # #     #   # # # #     # #   #   #     #       #   #   #
# ####### ### ### # ### # ### ####### ### ### ### ### ####### ### ### ##### ### #
# # # # #   #   #   # # #   #   # # # # # # #   # # # #   # #       # # # #   # #
# # # # # ### ##### # # # ### # # # # # # # # ##### ##### # # ### # ### # ##### #
#     # #   #   #             #   #     #         #         #   # # # #   # #   #
### ### # ### ##### ############### ##### ######### # # ####### ### # # ### #####
# # #   # #   #     # # #   # #       #   #         # # #   # # #       # #     #
# # # # # ### # ##### # # ### ### ####### ### ########### ### ####### # # # #####
#   # # # # # #   #   #   #   # # # # #                         #   # #       # #
### ### # # # # ##### # # ### # # # # # ### # # ### ####### ### # ##### ####### #
# #   # #         #   # # #     #         # # # #   #       # #   # # #     #   #
# # # # # ### # ##### # ##### ### ### ############# ####### # ### # # ######### #
# # #   # #   #                   # # #   #       # # #         # #     #   # # #
# ### ### ### # # ### ### ### # ### ##### # ####### # ##### # # ### ####### # # #
#   #   #   # # #   #   # #   #                   # #   # # # #         # # #   #
# ##### # ##### ######### ### # # ################### ### # ### # # ##### # # ###
# # #     #   #   # #       # # #       #         #       #   # # #   #     # # #
# # # # # ### ##### ### # ####### ##### ### ######### ##### ########### ##### # #
#   # # #   #   #   # # # # #       # #             #   # # #   #     #   #     #
# ##### ##### ### ### ##### ### # # # ##### # # # ### ### # ### ### ### ##### ###
#     #   # #                 # # #     # # # # #     # # # # # #   #   # # #   #
# # ### ### # ### # ### ### ### # ##### # # ### ##### # # ### # # # ### # # # ###
# #             # # #   #   # # # #       #   # #       #     # # # # # #     # #
# ### ##### ######### # # # # ######### ### ### ##### # # ##### # ### # ##### # #
# # #     #         # # # # # # #       # # #   # #   #   # #                   #
### # # ### ######### ##### # # ### ### # # ### # # # # ### # ##### # ### ### ###
# #   #   #         # #   #     # # # # # #   #   # # #       # #   # #     #   #
# # # ### # ####### ##### # # # # ### # # ### # ### ##### # # # # ### # # # # # #
#   #   # # # #   #   #   # # #     #     # # #   #   #   # #   # #   # # # # # #
### # ##### # # # # ### ### # ### ### ### # ####### ##### # ### # ### ### # # # #
#   #     #     # #       # # #     #   #   #   # #   #   # # # #   # #   # # # #
### # ####### # ##### ### # ##### ### # # ### ### ### # # ### ### ### ### ### # #
#   #   #   # #   #   #   #     #   # # # #         # # #       # #     #   # # #
### # ### # ### ##### # # ####### ### # # ### # ### ##### # # ### ### # ### ### #
#   #     #   #   #   # #       #   # # #     # #     #   # # #   #   #   # #   #
########################################################################### #####

