### #############################################################################
#   #   #       # # # # #   #           #   #                       #   #       #
### # # # # # ### # # # # ### ############# ### ### ################# ### #######
# # # #   # # #     # #   #       #       # #     #   # #                       #
# # ### # ##### ##### ### ### ### # ####### ### ####### # # ### # # # # # ##### #
#       # # #     # # #     #   # #     #     #   #       # # # # # # # #     # #
##### # ### # ##### # ### ### ##### ##### # ### ##### ### # # ##### ##### #######
# # # # # #         # # # #   #         # #         # # # #       # # #       # #
# # ### # # ### ##### # # # # # ########### # # ##### # ####### ##### ######### #
#   #       #     # #       #   # # # #   # # # # #       #   # #   #       # # #
# ### # ####### ### # ########### # # # ##### ### # ####### ##### ####### ### # #
# #   #       #   #           #     #     #         #       #         #   #     #
# ##### ######### ##### # ##### ####### ##### # # ##### # ##### ### ##### ### ###
#   #       #   # #   # # #       # # # #   # # #       # #       # # # # #     #
# ####### ### ####### # ### # # ### # # # ### ############# ######### # # ### ###
# # # #       # #           # # #   #   #       # #               #   #   # #   #
# # # ### ##### ####### ########### ### # ####### # # ### # ### ##### ### # # ###
# # # # #         #   #   #   #   # # #     #     # # # # #   #               # #
# # # # # ######### ### ##### # ### # # ######### # ### ################# ##### #
# #   #     #     # #       # # # #           #         #   #     #     #       #
# # ##### ### ##### # ### ### # # # ############# ##### ### # ####### ### # ### #
#   #   #       # #     #     # #   #     # # #       #                 # #   # #
# # ### ### # ### ### # ####### # # ### ### # ### ### ####### # #################
# # #     # #   #   # # # #       #   # # #         #   #   # # #           #   #
# ####### # ##### ### ### ### ### ##### # ### ### ####### ####### # ####### ### #
#       #                     # #     #     # #                   # # #   #   # #
# # ##### # # # # ### # # ### # ####### ##### ##### # # # # ######### ### ##### #
# #   # # # # # # # # # #   # #       #   #   # # # # # # # # # #   #   # #   # #
# ##### ### ##### # # ######### ### ### ### # # # # ### ##### # ### # ### # ### #
#       # #     #   #     # # # #           #     #   #               # #       #
# ####### # ############# # # ####### ##### ### # ### # # # # # ####### # ### ###
# # # # # # #   #       #   #   #   #     # #   #   # # # # # # #       #   # # #
# # # # # # ### # ########### ### # # # ############### ##### ##### ### # ##### #
#     #             #   # #     # #   # #     #       # #   # # #   #           #
# # # # ### ########### # ### ##### ### ### ##### ####### ##### # ### # # ### # #
# # # #   # # # #   # #       #   # #     #   #       #           #   # #   # # #
# ### # ### # # # ### # ####### ### ### ### ##### ##### ##### ### ##### #########
#   # # # #   # # # # #   # # #       # #     #     # #     # # #     # #   # # #
# # ##### # ### # # # # # # # # ########### ##### ### # ####### ### ##### ### # #
# #   # #   #           # #         #     #                     #               #
# ##### # ####### ########### ####### ####### ##### # # # # ########### # # # # #
# #   #     #       # #   #   #     #       #   #   # # # # #         # # # # # #
# # ##### ##### ### # # ### ### ##### ####### ##### ########### ### ##### ### # #
#       #       # #     # # # #   # #           #   #   # #     #       # # # # #
# ### ### # # ### ### ### # # # ### # # ##### # ### ### # # ### ### # ### # ### #
# # # # # # #     #                   #     # # #             #   # #   # #   # #
# # ### # ### # ### ### # # ### ### # # # ### # # # # # ############# # ### #####
#     # # # # # # #   # # # #     # # # # #   # # # # #   # #     # # # # # #   #
### ### ### # ### ##### ##### ######### # # ######### ### # # ##### ##### # ### #
# #       #       # # # # # # #   #   # # #         #   #   #     #       #     #
# ### ##### ####### # ### # ### ### # ####### ####### ####### # ### ### ### ### #
# # #   #                           #   #   #   # #           #   #   #       # #
# # # ### # ### ####### # # # ### # # # ### # ### ### # # ### ##### ##### ##### #
#   #     # #       #   # # # # # # # #     # # # # # # #   # # #     # #   #   #
# # # ### ##### ### ### ### ### # # # ##### ### # # ##### ### # # ##### # # ### #
# #     #     # #     # #     #   # #   #             #     #           # # #   #
################################### #############################################

