############### #################################################################
#     #     # #   #     # # #     # # #     #           #       #   # # # # # # #
# # # # # # # # ####### # # ##### # # # ##### ####### ### ####### ### # # # # # #
# # #   # # # #   #     # # # # # # # #       # #       #       #   # # # # # # #
# # # # # ### # ####### # # # # # # # ##### # # # ### ### ####### # # # # # # # #
# # # # #   # #   #   # #   # #   #         # #   #             # # # # # # # # #
# # # # ### # # ### # # # # # # # # # # # # # ### ####### ####### # # # # # # # #
# # # # #     #   # # # # # # # #   # # # # # #         #       # # # # # # # # #
########### ### ### # # # ### # # # # # # # ############# ####### ### # # # # # #
#             # # # #   # # # # # # # # # # # #   # # #         # # #     # # # #
# ############# # # # # # # # # # # # # ### # # # # # # # # # # # # # # # # # # #
#             #     # #     # # # # # #   # #   # #   # # # # # #   # # # # #   #
# ############# # # # # # ### # # # # ### # ##### # # # ### # # # ### # # # # # #
#             # # # # # #   #   # # # # # # # #     #     # # # #   # # #     # #
##### ######### # # # # # ####### ### # # # # # # # # ### # # # ### ######### ###
#     #   #   # # # # # #   #     # # #   # #   # # # #   # # # #   #     # #   #
# # # ### ### ########### ####### # ################### ########### ### # # ### #
# # # #   #   #   #   # #   #     # #       # # #         #   # #   #   #       #
# # # # # # # # # # # # # # ### ### ##### # # # ##### ### # ### # ### ##### # ###
# # # # #   # # #   #     # #       #     # #         #     # # #   #   #   #   #
# # # # ##### ########### ##### ### ### ### ### # ######### # # ### ####### #####
# # #     #   #     # #   # #     # #     #     #         #     #   #           #
####### ####### ##### # # # ########################### ######### ####### #######
#             #         #   #         #     #         # #   # # #   #           #
########### ######### ############### ##### # ####### # # # # # # ####### #######
#   #   # #   # # #         # #     # #     #       # # # # # #     #   # # # # #
# # # # # # # # # # ### ### # ### # # ##### # ####### # # # # # # ### ### # # # #
# # # #   # # #     #     # #     #   #     #       # #   #     # # #     #   # #
# # # # # # # ########### ##### ######### ### ####### # # ##### # # # ### # # # #
# #   # #   # #           # #           #   #       # # # #     #   #   # # #   #
# # # # # # # # # ### # # # ####### ### ### # # # ### # # ### ### # # # # # #####
# # # # # # # # #   # # #   #         #       # #   #   # #     # # # # #       #
# ########### # ####### ############# ############################# ### # #######
# # #     #   # # # # # #   # # # # #                           #   # # # #   # #
# # ### ### ### # # # # # # # # # # ### ######################### # # # # # # # #
# #   #   #   #       #   # # # # # #     #               # #   # # # # # # # # #
# # # # # ### ########### ### # # # # # # ########### ##### ### # # # # # # # # #
# # #   #     #             # # # # # # # # #   #         # # # # # #   #   #   #
# # ##### ### ######### ##### # # # # # # # # ### # ####### # # ### ######### ###
# # #     #     # #   # # # # # # # # # # # #   # #         #   #     #   #     #
######### ##### # # # # # # # # # # # # # # # ### ##### ### # # ### # # # # # ###
# #   # #   # #     #       # # # # # # #       # #       #   # #   #   # # #   #
# # # # # ### # ### # # # ### # # # # # ### # ### ##### ### # ### ### # # # # # #
#   #         # #   # # #   #         #   # #     #       # #   #   # # #   # # #
# ### # # ### ############# ########### ########################### # ###########
# #   # #   # #             # #     #                         # #   #           #
# # # # ### # ########### ### # ####################### ####### # # ########### #
# # # # #   # # #         # # #                           #   # # # #           #
##### ######### # # ##### # # ##### # # ################### ### # # # ###########
#             #   #     #   # #     # #                       # # # #       #   #
### ########### ############# # ##################### ######### # # ##### ### ###
#   #       # # # #                 #                           # # #       #   #
# ### # ##### # # # ### ##### ##### ############# ### # ### # # # # ### ##### ###
#     #       #     #       # #     #               # #   # # # # # #           #
####### #########################################################################

