########################################### #####################################
# # # #             #                                                           #
# # # ############# ################# ###########################################
# # #   #           #                                                           #
# # # # ##### ########################################################### #######
# # # #             # # #           #     #     #       #     #           # #   #
# # # ##### ######### # ########### ##### ##### ### ####### ########### ### # ###
# # # #             # # #           #           # #   # # # # #   # # # # # #   #
# # # ######### ##### # ######### ########### ### # # # # # # ### # # # # # ### #
# #   #           # # #         # # #   # #   # # # # # #   #           # # #   #
# # # ##### ####### # # # ####### # # # # # # # # # # # # # # ### # # # # # ### #
# # # #             # # #   # #   # # # # # #   #   #     #   #   # # # # #   # #
# ################# # # ### # # # # # # # # ##### # # # # ##### # # # # # # # # #
# # #   # #         # # #       # # # # #       # # # # #     # # # # #     # # #
# # # # # # ### ### # # # ### # # # # # # ### ### # ##### ### # # # # ### # # # #
# #   #       #   # # # #   # # #     #   #       #     # #   # # # #   # # # # #
# ### ########### # # # ##### ############################################# # # #
# #     #         # #   #                       #                           #   #
# ############# ################################################# ###############
# # #               #     # #   # # # # #   # # # # # #       # #               #
# # ### ### ######### # ### # # # # # # # ### # # # # ### ##### ########### #####
#   #   #           # # # #   # # #     # #       #   #       #                 #
# # ############# ### # # # ### # # # # # # # # # # ### ####### ######### #######
# # #       # #     # #       #     # #     # # #               #               #
# # ####### # ##### ####################################### #####################
# # #       # #     # # # # # #       # # #           #   # # # #   # #   #   # #
# # ##### ### ##### # # # # # ##### ### # ########### ### # # # # # # ### ### # #
# # #               # # # # # #       #   # #     # # #     #   # #   #   # # # #
# # ####### ######### # # # # ### ####### # # # # # # ### # # # # # # ### # # # #
# # #   # #         # # # # # #               # #     #   # # #   # # # #   # # #
# # # ### # ####### # # # # # ################# ######### # # # # # # # # # # # #
# # #   #         # # # # # # #       #     #     #   #   #   # # # #     # #   #
# # ### # ##### ##### # # # # ##### ##### ### # # # # ### ####### # # # # # # # #
# #     # #         # # # # # #   #   #     # # #   # # #     # # # # # # #   # #
# # ### # ##### ##### # # # # # # ### ### ### # # # # # # ##### ##### # # ##### #
# # #     # #       # # # #   # # #         # # # # # #         #     # # #     #
# # ##### # # ##### # # # # # # # ### ##### # # # # # # ##### # ### ####### #####
# # #     #   #     # # # # # # #     #       # # # # # # #   # #         #     #
# # # # ######### ### # # # # ####### ############# ### # # ### ##### ##### ### #
# # # #   #         # # # # #         #                 #     # #         # #   #
# ############### ### # # ##################################### #################
# # #               # # # #     # #   # # # # # # #   # # # #             #   # #
# # ##### ########### # # # # # # # # # # # # # # # # # # # ##### ### ##### # # #
# # #               # # # # # # #   # # # #   # # # # # #   #       #       # # #
# # ##### ####### ### # # # ### # # # # # # # # # # # # # # ####### ##### ### # #
# #         #       # # #     #   # #       #       #     #         #       #   #
# ############# ##### # # ####################################### ###############
# #     # # # # #   # #   #                           #         #     #         #
# # # # # # # # ### # # # ############# ### # # ######### ##### ##### ### #######
# # # #     #       # # # # #     #   #   # # # #         # # #         # # # # #
# # ####### # # ### # # # # # ### # ### # # # # # # # # # # # # # ##### # # # # #
# #   #     # # #       # # # # #       # # # #   # # # #     # #     # # # # # #
# ### # ##### # # # # # # # # # # # ##### ##################### # ##### # # # # #
# #   #       # # # # # # #     # #     # #                     #     #         #
######### #######################################################################

