############################################################################### #
# # #             #   #     # #                 # #   #           #     # #     #
# # # # ### ### # # # ### # # # # # # # ####### # ### # # # # # # ##### # ### # #
#   # # #   #   # # # #   # #   # # # # #       #       # # # # # #     #     # #
# ### # ##### ### # # ### # # ######### # ################# ########### # # ### #
#     # #   #   #   #     # # #         #       #                 #     # #   # #
# # # # ### # ### # # # ### ########### ################### ######### ### # # # #
# # # # #       # # # #   #                                               # # # #
##################################################################### ###########
#                                               #   #   #                   #   #
# ####### ##################################### # # # # # ### ### ##### ### # # #
# #                                         # #   #   #   #   #   #       #   # #
# ######### ################################# # ####### ##### ##### #############
# #                                           # #         #   #                 #
####### #########################################################################
# # #       #                     # #                                           #
# # ##### # # ############### ### # ########################### #################
#         #   #                 #           #   # # #   #     # #               #
### ######### ### ############# # # # ### # # # # # # # # # # # # ### ##### #####
#           # #               # # # #   # #   #       #   # #     #   #         #
############################# ###################################################
#         # #       #   #         # # #       # #                     # #       #
######### # # ### ### ##### ####### # ### ### # ################# ##### ####### #
#         # # #       #           #         # # #                               #
######### # # # ### # # ### ####### # # ##### # ######### ############# # #######
#             #   # #   #           # #     #                         # #       #
######################################################################### #######
# # #   # #   #   # # # # # # # #   # # #     # # # #     #           # #   # # #
# # ### # ### # ### # # # # # # # ### # # # # # # # # ### # # ######### # # # # #
# #       #   #       # # # # # #   #   # # # #     # #   # #             #   # #
# # # # # # ### ####### # # # # ### # # # # # # # # # ### # # # ### ######### # #
# # # # # #   #       # # # # # #     #   # #   # #   #     # # #     #       # #
# # # # # ### ####### # # # # # ############################### ############### #
# # # # # #   #       #   # #   #                                             # #
# ### ### # ### # # ### # # # # ##### ######################################### #
# #     # # # # # #   # #   # # #                                             # #
# # ##### # # ##### ### # # # # # ############################################# #
# #     #   #     # #   # # # # #             #     # #         # # #         # #
# ##### ### # # # # # # # # # # # # ############# ### # # ####### # # # ####### #
# #       #   # #     # # # # # # # #         #     # # # #   # # # # #   # # # #
# ####### ### # ##### # # # # # # # # # # # # # ##### # # # # # # # # # # # # # #
#   #   # #   # #     # # # # #   #   # # # # #   # # # #   #   #     # # #   # #
# # ### # # # ####### # # # # # # ########### # ### # # ##### ##### ### # # # # #
# #       # # #       # # #   # # #   #       #     # # #             # #   # # #
# # # ##### ########### # # # # # # # ### ##### ### # # ##### ################# #
# # #     #           # # # # # # # #         #   #   # #                     # #
##### ############# ### # # # # # # ######### # ##### # ############### ####### #
#         #   #     # # # # # # # #   #         # # # # # # #   # # # #   #   # #
### ######### # ##### # # # # # # ##### ####### # # # # # # ### # # # # # # # # #
#         #           # # # # # # #           # # # # # # # #   #   # # # # # # #
####### ##### ########### ##### # ############# # # # # # # # ### # # # # # # # #
#     #   #       # # #       # #             # #   # # #     # # #   # # # # # #
# ##### # ### ### # # ####### # ####### ####### ### # # # # # # # # # # # # # # #
#       # #   #       #       # #             #     #   # # #     # #   #   #   #
############################################################# ###################

