############################### #################################################
#     #             # #   #   # # # # #           # #   #   # #   #     #       #
### ### # ########### # ### ### # # # ####### # # # ### # ### # ####### # #######
#     # #           #     #     #   # #       # # #               # # # # # #   #
### ############# ### ### # # # # # # # ##### # # ### ####### ### # # # # # # ###
#     #   # #       # #     # # # # # # #     # # #   # #     #   # # # # # #   #
### ##### # ### # # # # ####### # # # ### ##### # ### # ######### # # # # # ### #
#     #         # # # #   #   # # # # #       # # #     #         # # # #   #   #
### ############# ### # ### # # # # # ### ########### # # # ##### # # # # # # ###
#   # #           # # #     # # # # # #     # # # #   # # #   #     #   # # #   #
### # # # # # # # # # ### # # # # # # # ##### # # ##### ##### ##### # # # # # # #
#   # # # # # # #   # #   # # #   #     # # # # # #     # #   #   # # # # #   # #
# ### ######### ############### ##### # # # # # # # ##### # # # # # # # # #######
#     #             # #   #   #     # # #   # #   #     #   #   # # # # #       #
# ### # ############# # # # ### # # # # # # # # # ### ####### ##### # # # # #####
#   # #             # # #   # # # # # #   # # # #       # #       #   # # #     #
# ### ########### ### # # # # # ### # # ##### # # # ##### ####### # # ### # #####
#   # # #       #   # # # #     # # # #       # # #   # #         # #     #     #
##### # # # ##### # # # # # ### # # # ##### # ### # # # ################# #######
#     # # #     # # #   # #   #   # # #     #     # #   #                       #
### ### # # ##### ##### #########################################################
#   # # # #     #   #   # #               #               #   #   #             #
### # # # ### ##### # ### ### ### # # ### ############# ### # # # ### ###########
#     # # #     # # #           # # #   #                 # #   # #   # #   #   #
# ##### # # ##### # ################### ################### # # # # # # # # # # #
# #   # # #     #   # # #   #                     #     # # # # # # # #   #   # #
# # # # # # ####### # # # # ##### ################# ##### # # # # # # ### #######
# # # # # #       # # # # # # # #   #       #   # # # # # # # # #   # #         #
# # # # # # ##### # # # # # # # # ####### # # ### # # # # ### ### # # ####### ###
#   # # # #     #   # # # # # #   #   # # #     #   # # # #     # # # #         #
##### # # ##### # # # # # # # # # # # # # ##### # # # # # ##### ### # ##### #####
#     # # #     # # # #   # # # # # # #   # # #   # #     # #     # #         # #
### ### # # ### ### # # # # # # # # # # # # # # # # # # # # # # ### # # # ### # #
#   # # # # #   #   # # # # #   #   #   # #     # #   # # # # #   # # # #   #   #
### # # # # # ### ### # # # ####### ############### ### # # # ### # # ### ##### #
#     #   # #   #   #   # # #                     # #   # #   #   # # #       # #
# ### ### ########### # # # ################### ### ### # ### ############### ###
#   # #   #       # # # # #                       # #   #         #             #
# ### # # # # ##### ##################################### #######################
#   #   # # #     # # # # # # # #                     #       # #               #
# # # # # # ##### # # # # # # # # ######### ### # ### # ##### # ### #############
# # # # # # #       # # # #   #   # # #   # #   #   # # # # #   #               #
### # # # # # ##### # # # # # # # # # # ### ### ####### # # # # ############# ###
#   # # #   #     # #   # # #   # # # #   # #             #   # #               #
# ### # ######### # # # # # # # # # # # # # ####### ### ### # # ####### #########
#   # # #         # # #   # # # #       # # #         #   # # # #       # # #   #
### # ####### ##### # # # # # # ####### ### ################# ####### ### # ### #
#   # #           #   # # # # # #         # #             #   #         # # #   #
# ### # ############# # # # ### # ######### ##### ######### # # # ####### # # # #
#   # # # #     #   # # #   # # #         # #               #   #       # #   # #
### # # # ### ### # # # # # # # # ####### # ### ################# ####### # # # #
#   # #   #       # # # # # #   # #       # #                   #           # # #
# # # # # ##### # # ####################################### #####################
# # # # #       # # #                                                           #
# ###############################################################################

