######################### #######################################################
#                                 # # #   #         #         # #   # # #   # # #
# ################################# # # # ##### ############# # ### # # # ### # #
# #     # # #   # #   #           #   # #               # # # #       # # # # # #
# # # # # # # # # ### # ##### ##### ### # ##### ##### ### # # # ####### # # # # #
#   # #       #         #         #     # #         #         #         #   # # #
################# ##################################### ######### ##### # # # # #
#         # #   # #     # #   #   #                           #   # # # # # # # #
####### ### # # # ##### # ### ### ########################### # # # # # # # # # #
#           # #     # # #   #   # # # #             #       # # # # # # # # #   #
### ####### # # # # # # # # # # # # # ####### ####### # ##### # # # # # # ### # #
#       # #   # # #       # # # # #                   #       # #   # #   # # # #
# # ### # # # ##### # # # # # # # # # ################# ####### # # # # # # # # #
# # #     # #     # # # # #   #   # # # # #   # # # #     #   # # # # # # #   # #
######### ######################### ### # ### # # # # ### # # # # # # # # # # # #
#       #       #           # # # #   # # #   # #   # #     # # # #   # #   # # #
# # # # ##### # # # # ### ### # # # ### # # ### # # # ##### # ##### ### # # # ###
# # # # #     # # # # #         # #   # # #   # # # #     # # # #   # # # # # # #
### # # # ##### # ### ####### # # ### # # ### # # # ####### # # # # # # # # # # #
#   # # #     # #   #       # #   #   # #       # # # # # # # #   #   # # # # # #
# # # ####### # # ########### ##### ### # # ### # # # # # # # ####### # # # # # #
# # #         # #   #     # #         #   #   # # # # # # # # #       # # # # # #
### ############# # ##### # ### # # ##### # # # # ### # # # # ##### ### # # # # #
#   # # #   # # # # #       # # # #   #   # # # #   # #     # #     # # # # # # #
# # # # # # # # # # ##### # # # # # # # # ### # # # # # # # # ##### # # # ### # #
# #       #     # # #     # #   # # # # # #   # # #     # # #   # #   # # # #   #
############# ### # ##### ##### ### # # ### ### # # # ####### # # # # # # # # # #
#               # # #       # # # # # #   # # #   # #       # #     # # #   # # #
### ############# # ##### ### # # ### ### # # # ### # ####### ### ##### # ### # #
#               # # # # # # #     #   # # #   # #   #     # # #       # # # # # #
############# ### ### # # # # # ##### # # # # # # # # ##### # ####### # # # # # #
#               #   #       # # # #   #   # # # # # #       # #     # # # # # # #
############### # ######### # # # ### # # ### # # # ##### ### # ### # # # # # # #
#                   #         #   #   # # #   # # # #       # #   #   # # # # # #
### ############# ########### ####################################### ### # # # #
# #       # #   # # #             #                                     # # # # #
# ##### # # ### # # ########### # ##################################### # # # # #
# #     #   #   # # #           # #                                     # # # # #
# ##### # # # # # # ##### ### # # ##### ################################# # ### #
# #     # #   # #   # #   #   # # # #       #   #   #   #   #   #   # # # # # # #
# ### ### ##### # # # # # ### # # # # # # # # ##### # ### # ### # # # # # # # # #
# # #   # #     # # #   # #   # # #   # # # # # #   #   # # # # # # #   #   # # #
# # # # # ##### # ####### ######### ### # # # # # ### ### # # # # # # # ### # # #
#     # # #     #   #             #   # # #   # #       # # #   # # # # #   # # #
################### ############### # ### # # # # # ### # # # # # # # # ### # # #
# # # #               # # #       # # #   # # # # # #     #   #   # # # #   # # #
# # # ### ##### ####### # # ##### ### ### # # # ##### ####### # # ### ##### # # #
#     #   # # #       # # #   #   #   #   # # # #           # # #   #   #   #   #
##### ### # # ##### ### # # ### # # ##### # # # ####### ##### # ### # # ### # # #
#   # #   #           # # #   # # #   #   # #               # # #     # #   # # #
# # # ### # # ####### # # ##### ########### ############################# ### # #
# #       # # #           #       #     # # # # # #                     # # # # #
##### ####### ################### ### ### # # # # # # ####### ########### # # # #
#         #                       #                 #     #             #   # # #
######################### #######################################################

