####################################################### #########################
#                             #                                                 #
# ########### ################# # # ### #########################################
#       #                       # # #                                           #
################################################################### #############
# #                   # #   # #   #   #             #     #   #         #   #   #
# # ################### ### # # # # ### ############# ### # # ####### ### # # ###
# # #   # # # #       #         #     #     # #   # #   # # # # #   # # # # #   #
# # # ### # # # ############# ########### # # # # # ### # # ### # # # # # # # # #
# # # # # #   # #   # #   # #   # #   #   #     #   #   # #       #     # #   # #
# # # # # # # # # ### ### # # # # # ########### ####### ##### ####### ### # # # #
# # # # #   # #       #   # # # # # # #   #   #     #   # #   #           # # # #
# # # # # # # # ####### ### # # # # # # ### ### ##### # # # ####### ##### # # # #
#   # # # # #         #   #   #   # # #   #         # #   # # #         # # # # #
# # # # # # # # ##### # ######### # # ### # ### ######### # # ####### ###########
# # # # # # # # #     # # #       #   #       #     #     # # #   # # #     #   #
# # # # ### ### # ##### # ####### # # ### ############# # # # # ### # # ### # ###
# # # # #   # # #     # # #       # #   # #   #   # #   #     #         #       #
# # # # # # # ##### ### # ### ##### ### # # ### # # ##### #######################
# # # # # # # #       #   #     # # # #   #     #   #   #   #               # # #
# # # # # # # ##### ##### ### ### # # # # ##### ##### # # # ######### ####### # #
# # # # # # # # #   # #   #       # # # #           # # # # #           #       #
# # # # # # # # # # # ### ####### # # ### ############# # # ########### # ### ###
# #   # # # # # # # # # # #       # # # # #   #     #     # #           #   #   #
# # # # # # # # ### # # # ### ##### # # # # # ### ##### # # # ########### # # # #
# # #     #   #     # # # # # # # # # #   # # # #   #   # #   #   # #   # # # # #
# # # # ### ### # ### # # # # # # # # ### # # # # # # ####### # # # # # # ### # #
# # # # # # # # #     #   # #     #   # # # #   # # #       #   #     #     # # #
# # # # # # # ####### # ### ##### ### # # # # # # # ################### #########
# # # # # #   #   # # #   #   #       # # # # # # # #     #           #       # #
# # # # # # # # ### # # ### # # ### ### # # # # # # ### ### # # ##### ####### # #
# # # # # # # #       #   # #     # # # # # # # # # #     # # # #               #
# # # # # # # # ### # # ### ### ### # # # # # # # # ##### # ################# ###
# # # # # # # #   # # #   # #     # # #   # # # # # # # #   #     #         #   #
# # # # # # # ### # ##### # ##### # # # # # # # # # # # # # ### # ##### ##### # #
# # # # #   # #   #   # #   #     # # # # # # #   # # # # # #   #             # #
# # ################### # # ### ### # # # # # # # # # # # # # # ######### #######
# #                   # # # #   # #   # # # # # # #   # # # # # #       #   #   #
# ########### ######### # # # # # # # # # # # # # # # # # # # # # ##### ### # # #
# # #                 # # # # #   # # # #   # # # # #     # # # #   #         # #
# # ######### # # # # # # # # # ##### # ############# # # # # # # ### ###########
# #           # # # # #   # # #   #   #   #   #     # # # # # # #   #           #
# ############### ############### ##### ##### # ### # ###########################
# #   #   # #     # # #       # #   # # #         # #       #     #     #   #   #
# # ### # # ### ### # # ##### # # # # # # # # ### # ### ### # # ### ### # ### ###
# #     #   # #     #   #   #   # #   #   # # #   # #     #   #   # #     # #   #
# ####### # # # # # # # ### # # # # # # ############# ####### # ##### ### # # ###
# #       #     # #   # #     #   # # #             #       # #         #       #
################################### #############################################
#                 # # #   # # #       #     #   #   #                 # # #     #
####### ####### ### # # ### # # ### # # # # # # # # # ############### # # ### ###
#           #     #     # # # #   # # # # #   #   #                 #           #
####### ####### ### # # # # # # ### # # # ################### ###################
#           #       # #           # #   # #                                     #
######################### #######################################################

