############################# ###################################################
# #   #       # # # #       # #     #           #       #     #       #     #   #
# # # # # ##### # # # # # # # # ### # # # # # # # ##### # # ### ### ### # # # # #
#   # # #     # # # # # # #     #     # # # # #       #   #   # # #   # # # # # #
### ### ### # # # # ##################### ##################### # # ##### # # # #
#       #   # # # #     #   # # #   #   #     #             # # # #   # # # # # #
# ##### ### ### # # # # # # # # # # # ### ##### # # ### ##### # # ### # # # # # #
#     # #     # # # # # # #   # # #     #     # # # #         # #         #   # #
# ########### # # # # ### # # # # # ### ##### ####### ######### # # # # #########
#       #   #     # #   # # # #   # #   #                       # # # #         #
####### # # # # # # # # # # # # # # # ##### ################# ### ###############
#       # #   # #   # #   # #   # # #         #               # #               #
############################################################# # ### ##### # # ###
#   # # # #                                                   #         # # #   #
# # # # # ############# ####################################################### #
# # # # # #                                                   #     #   #       #
# # # # # ############# ####################################### # ### ####### # #
# # # # # # #   # #       # #   # # #   # # # # # #   # # # # # #   # # #     # #
# # # # # # # ### # ### ### ### # # ### # # # # # # # # # # # # # ### # ### # # #
# # # # #   # # # #   #   #     # # # # # # # #   # # #   # # # #           # # #
# # # # # # # # # ##### ##### ### # # # # # # # # # # # ### # ####### ###########
# # #     # #   #         #   # # # #   # # #   #   #     #   #     #           #
# # # ### # ### # # ####### # # # # # ### # # # ########### # ### # # ##### # # #
# # #   # # # # # #       # # # # # #   # #   #             # #   #   #     # # #
# # # ##### # # ### ####### ### # # ### # # # # ########### # ################# #
# #     # # #   #         #         # # # # # #     #     # # #                 #
# # # # # # # # ####### ####### # # # # # # # ##### # # ##### ### ###############
# # # # # #   # #   #     # #   # # #   # # # #       #   #   #         # # #   #
# # # # # # # # # # # ##### ### # # ### # # # # ##### ### # ####### ##### # ### #
# # # # # # # #   #             # # #     # # #     # #   #   # #       # # # # #
# # ### # ############### ########### ### # # ######### ##### # ### ##### # # # #
# # #     #       # # # # # #   #   #   # # # #           #   #   # # # # #     #
### ####### ####### # # # # ### ### ### # # # ### ######### ### # # # # # # # ###
# #       #     # #   # #       #   #   #   # #           #   # #         # #   #
# ### ##### ##### # # # ####### ### # ### # # ####### ######### ##### ### # #####
#         # # #   # #           #   #   # # # #               # #       #       #
# ######### # # # # # ##### # ### ##### ####################### #################
#         # #   # # # # #   #       #   # #         #   # #   # #             # #
####### ### # # # # # # # ########### # # # ### # ### # # # # # # ### ##### # # #
#     #   #   # # # #   #     # #     #     #   #     #     # #   #       # #   #
# # # # ### # # # # # # ### ### # # # # ### # # ### # # ### ############### #####
# # #     # # # #   # # #         # # # #   # # #   # # #     #                 #
################################### #############################################
# #   # #     # # #     # # #     #   #       # #   # #       # #       #       #
# # # # # ### # # # # ### # # # ### # ##### ### # ### ### ### # ### ### # ### ###
#   #     #         #         #     #         #       #     # #       #   #     #
# ############# ############################# # ######### # # # ##### # # ##### #
# #                                   #                   # #   #     # # #     #
# # ##################################### ############# ####################### #
# #                                   #       #           # #   # # #     #     #
# # ################################### ####### ######### # # # # # # ####### ###
# #                                   #       # #             #     # #   #     #
# ##### ################################### ##################### ### ### ### ###
# #                                   #       #                           #     #
####################### #########################################################

