####################### #########################################################
#     #       #   # # # #       # #       # # #         # # #       #       #   #
# ####### ##### ### # # ### # # # ### ##### # ##### ##### # # ######### ##### ###
# # #                 # #   # #             # #   #     #   #       # #       # #
# # # ####### # # # # # ### # # # # ####### # # # # # ### # ####### # # ##### # #
# #   #       # # # #       # # # #       #     #   #     #                 #   #
# # # # ########### ######################### # ################# ### # # ### ###
#   # #       #     #                         #             #       # # #   #   #
############# ###################################################################
#   #   #         #   #     # # #     #   # # # # #   #   #     # #         #   #
# ### ####### ####### ### ### # # # ### # # # # # ### # # # ##### # ####### # # #
#                     #     # #   #   # # # # #       # # #     # #       # # # #
########### ####### ### ##### # # # ### # # # # # ### # # ### ### ####### # # # #
#               # # #           # #   # # #     # #     #         #       #   # #
######### # # ### # # ### ### # # ### # # # # ############### ### # ####### #####
#         # #     #   #     # # # #     #   # #                 #         #     #
############################################################# ###################
# # # #     # #     # # # #   #   # #     #               #       # # #         #
# # # # ### # ### ### # # # # # # # # # # # ##### # ########### # # # # #########
#     # #   #       # # #   #   # # # # # #     # #             #   #           #
##### # ### # ### ### # # # # # # # ### ##### ######### ######### # # ####### ###
#       #   # #     # # # # # # #   #           #               # #   #         #
### ### ### # ##### # # ##### ##### ##### #######################################
#     # #     #       # #         # #   #   # #             #               # # #
# ########### # ##### # ##### ######### # # # ### ##################### ##### # #
#   #   #   # #     #   # #   # #   #     #   #       #     # # #     # # # #   #
# # # # # # # ####### # # ### # # # ### # # # # # # ####### # # ### ### # # # ###
# #   #   # #       # # #         # # # # # #   # #         #     #     # # # # #
########### ########### ### ### # # # # # ### ############### # # # # # # # # # #
#   # # #     # # #   # #     # # # #   # # #               # # #   # # #   # # #
# # # # # # # # # # # # ####### ##### # # # # # ########### ####### ### # # # # #
# #   # # # #   #   # #             # # # # # #         #             # # # # # #
# # # # ##### # # # # # ####### ##### ### # # # ######### ##### # # ### # # # # #
# # # # #   # # # # # # #           # # # #   #         #   #   # #   #   # # # #
# # # # # ### # ### # # ########### # # # ### ####################### # # # # # #
# # # # #     # #   # # # #       # #   # # # #             #         # # # # # #
# # # # ##### # ### ### # ### ##### # ### # # ### ####### # ### ####### # # # # #
# # #   #     # #     # # # # # #   #   # #       #       # #     #   # # # #   #
# # # # ### ##### ##### # # # # # # # # # ############# ####### # # # # # # # # #
# # # # #   # # # # # # # #       # # # # #                 #   #   # # # #   # #
### # # # # # # # # # # # ### ### # ######################################### ###
# # # # # # #   #   # # # #     # # #                                           #
# # # # # # # # # # # # # # ### # # ########### #################################
# # # # # # # # # # # # #   #   # # #             # # # # #   #     #     #     #
# # # # # # # # # # # # # ########### ##### ### # # # # # # # # # # ##### # ### #
#   # # # # # # # #   # # # # # #     #       # #           #   # #         #   #
# ### # # # # # # # # # # # # # # # ################################### #########
# # # # # # # # # # # # #   # # # # #                   # # #                   #
# # # # # # # # # # # # ### # # # # # # ################# # ######### ###########
#   # # # # # # # # # # #         # # #                   # # #   #     # # #   #
# # # # # # # # # # # # ### # # # # ################# ### # # ### # # # # # # # #
# # # #   #   #   # # # #   # # # # #                   #           # #       # #
########################################################################### #####
#                                                                               #
# ###############################################################################

