##################################################################### ###########
# # # # #       #         # # # # #   # #   #     #     # #           # #       #
# # # # # ##### ### ####### # # # ### # # # # ####### # # # # # # # ### ####### #
#     # #     # #     # # # # # # #   # # # #   # #   #     # # # #   # #       #
# # # # ### ##### ### # # # # # # # ### # # # ### ##### ########### # # # ### ###
# # #   #       # #   # # # # # # # # # # # #   # # # #   #   #   # #   # # # # #
# # # # ##### ### ##### # # # # # # # # # # ### # # # # # # # # # # # # # # # # #
# # # #         #     # # # # # # # # # # # #   # # # # #   # # # # # # # # # # #
# # # # ####### ### ### # # # # # # # # # ### ### # # ### # # # ##### # # # # # #
# # # # # #     #   # # # # # # # #   # # # #   # #       # #     #   # # # # # #
# ### ### ##### # # # # # # # # # # # # # # # ### # ############### ### # # # # #
# #   # # #   # # #     # #   # # # # # # # #   #   # # # #   #   # # # # #     #
# # # # # ### # ####### # ### # # # # # # # # ### # # # # ### ### # # # # ### # #
# # # # # #   # # #     # #       # # # # # # # # #     # #   # # #   # # #   # #
# # # # # ### # # ##### # # ### # # # # # # # # # # # # # # ### # # # # # # ### #
# # #   #       # #   # # #   # # # # # #   # # # # # #   #   # # # # #   #   # #
# # ##### ### ### # # # # # ### # # ### # # # # # # # ### ### # # # # # # #######
# #     # #     # # #     #   # # #   # # # #   # # #   # # # #   # # # # #   # #
### ##### # ##### ##### # ### ####### # ### ### # ##### ### # # # # # # # # ### #
#   #   # #     # #     # #       #     # # #   # # # #     # # # # # # #       #
# # ### ##### ### ### # # ### ##### ### # # # # # # # # ### # # # # # ### #######
# # #   #   #         # # # # # # #   # # # # # # # # #   #   # # # # #         #
# # # # ### # # # # ### # # # # # # ##### # # # # # # ### # # # # ############# #
# # # # #   # # # #   # # # # # # #         # # # #     # # # # # #             #
# ### # ### # # ##### ### # # # # ### ### # # ### # ### # # ### # ########### ###
# # # # #     # #       # # # # # # #   # # #   # #   #   #   # # # #         # #
# # # # # # # # ##### ### # # # # # # # # ### ### # ### # # ### # # # # ### ### #
#   # # # # # # #       # # #   # # # # #   #   # #   # # #     # #   #   #     #
# # # # # ########### ### # # # # # # # ### ### # ########### ######### ### # # #
# # # # #   #   #       # # # # # #   # #         #               #       # # # #
### # ### # # # ##### ### # # # # ##### ##### ###################################
# # #   # # # # #       # # # # # # # # #       #               #   # # #   #   #
# # ### # # # ########### # # # # # # # ####### ######### ######### # # ### # ###
# # #   # # #   #         #   # # # #   #   # # # #   # #     # #             # #
# # # ### # # ######### ### # # # # # # # # # # # # # # ##### # ######### ### # #
# #     # # #   # #       # # #   # # # # # #   # # # # #       #           #   #
# # # # # # # ### # ### # # # # # # ### # # ### # # # # # ##### # ############# #
#   # # # #     #   #   # # # # # #     # # # # # # #   #     #           # #   #
### # # # ### ##### ######### # # # # ### # # # # # ### # ##### ### ### ### # # #
# # # # # # #   # #       #   # # # #   # # #   #   #   # #   # # # #     # # # #
# # # ### # # # # # ##### ### # # # ####### # ### # # ### # # # # # ### ### # # #
# # # # # #   # #   #     #   # # # #   # # #   # # #   #   # # #   #       # # #
# # # # ### ######### ####### # # # ### # # ### # # ### # ##### # ###############
#   #   # # # # #       # #   # #       #   # # # # #   #     # #       # # #   #
# # # # # # # # ### ### # ### # # # ##### # # # # # ### ##### ### # ### # # # ###
# # # # # #     # #   # #     # # #   # # # #     # #   # # #   # # #     # #   #
### # ### # # # # # # # # ### # # # # # # ### # # # # ### # # # # # # # # # # # #
# # # # #   # # #   # #   # # # # # #   #   # # # # #   #     # # # # # # # # # #
# # # # # ################# # # # ##### # ### # ### ### # # ### # # ####### # # #
#   #   # # #   #         #   # # #     #     # #   #     # #   # #           # #
# # ### # # ### ##### ####### # # ### ################################# #########
# # #   # # #             #   # # #     #                       # # #         # #
# # ### # # # # # ############### # ############# ##### ######### # # # ####### #
# # #   #     # #         #       #     #             #               #         #
##### ###########################################################################

