####### #########################################################################
#       #                             #       #         # # #   #   # #     # # #
##### ### ### # ##### ################### ######### ##### # ### # # # ##### # # #
#           # # # # # #         # # # #       #   #     #       # # # #     # # #
##### ##### # # # # # # # ####### # # ##### ### # # # # ### ##### # # ##### # # #
# # # # #   # # #   # # #   #   # # # #       # #   # #     # # # # # #     # # #
# # # # # ####### # # # # # # # # # # ### ######### ##### # # # # # # ### ### # #
#     # #       # #   # # #   #   # # #   # #       #   # #   # # #   #     #   #
##### # ##### ### # # # ### ### # # # # # # # # # # # # # ##### # ### ### ### # #
#       # # #   # # # # #     # # # # # #     # # #   # #       # # # #       # #
### ### # # # # # # # # ### ##### # # # # # # ####### ####### # # # # ### #######
#     # #     # # # # # # #   # # # #   # # # #         #     # #   # # #   # # #
##### ##### # # # # # # # # # # # # # ############### ############# # # # ### # #
#     # #   # # # # #   #   #   #   # #                         #   # # #   # # #
# # # # ### ######### ### ####### # # ##################### ####### # # ### # # #
# # #   #       #       #       # #   #                         #   #   # # # # #
############################# ################################### # # # # # # # #
#                           #                 # # #     # # # # # # # # # #   # #
####################### ################### # # # # # # # # # # # ### # # # # # #
# # # #           # #   #   #   #           # # # # # # # #     #   # #     #   #
# # # ##### ### # # # # # # # ### ##### ##### # # # # # # # ### # # # # ##### # #
# #   #       # #   # # # # #     #         #       # # # # #   # # # #     # # #
# ### ########### ### # # ############### ##### ### # # # # ### # ### ##### #####
# # # #               # #   #               #   #   # # #   #       # #         #
# # # ############# ####### ### ######################### ############# #########
# # # # # #                 #                           #       #               #
# # # # # ####### ######### ################# ################# ######### #######
# # # #   #             #   #     # #       #   #   #     #     # #   #     # # #
# # # ### ####### ######### # # # # ### # ### # # # # # # # # ### # # # # # # # #
# #   # # #             #   # # # #     #     #   #   # # # #   #   #   # #     #
# # # # # ##### ######### ### ### ################# ##### # # # ### #############
# # #     #             #   # #   # # # # # # #   # # # # # # # #               #
# # ### # ##### ######### ### # ### # # # # # # # # # # # # ####### #############
#     # #               #   # #   #   # # # #   # # #   # #     #               #
########### ################# ##### # # # # # # # # ### # ### ### # # ##### #####
#   #             #         # #   # #   # #   # # # #   # #     # # #   #       #
# # # ####### ### # ####### # # ### # # # # # # # # # ### # # # ############# ###
# #         # #     #       #       # #   # # # # #     # # # # #   #       # # #
################# ############# ### # # # # # # ### # ### # # # # # ####### # # #
#       # #         #       # #   # # # #   # #     # # # # # # # # #           #
####### # ### ##### ##### ### # # # # # # # # # # # # # # # ### ### ##### ### # #
#     # # # #   # # #     # #   # # # # # # # # # # #   #   #   #           # # #
##### # # # # # # # # # ### ### ######### ############### # ### ##### ###########
#         # # # # # # # # # #     # # #         #     # # # # # #       # #     #
# ######### ### # # # # # # # ##### # # # ######### # # # # # # # # # # # ### ###
# #   # # # # # # #   #     # # # # #   #           # # # # #   # # # #         #
# # # # # # # # # # # # ### # # # # ####### ##### ##### # # ### # ###############
# # # # # #       # # #   # # #   #             #       # # #   # #   #     #   #
# # # # # # # # # # ##### ### # # ######### ########### ####### # ### # # # # ###
#   #     # # # # # #   # #     # #           #   #   # #       #       # # # # #
# ####### ##### ### # # # # ##### ##### ### ### ##### # # ######### ### # # # # #
# #   # #   # #   # # #   # #   # #     #     # #     # #       #   # # # #     #
# # # # # # # # # # # ### # # # # ########### # # # ### # ####### # # # ##### ###
# # #     #     # # #   #   # #   #               #   # #       # #   #     #   #
########### #####################################################################

