########################################### #####################################
#                                                                               #
### ### ### ### ##### # # ### # ### ### # # ### # # # ### ##### ####### ### # # #
#     # #   #       # # # #   # #     # # #   # # # #   # #     #       #   # # #
# # ####### # # # # # # ### # # # # # # # ### # ####### ### # # ### # ### # #####
# #   #     # # # # # # #   # # # # # # # #   #   #     #   # # #   #   # #     #
# # # ######### ### # # # ##### # # # # ### ####### # ####### ### ##### ##### # #
# # #       #   #   # # #     # # # # # #     #     #     #     #     #   #   # #
# ####### ##### # ### ####### ### # # # ### # ####### # # ### # # # ######### ###
#       #   #   # #       #   #   # # #   # #   #     # #   # # # # #           #
# # ##### # ##### # # ##### # ### # ### # ##### ##### ##### ##### ##### ### ### #
# #   #   #     # # # #     #   # #   # # #       #     #       #   #     # #   #
##### # ### ##### # # # # ### ######### # ### # # # # # # ##### ##### ##### ### #
#     #   # #     # # # # #     #       # #   # # # # # #     #     #     #   # #
# ####### # ##### # # ######### ### ########### # # ######### # # # # ####### ###
# #       #   #   # #   #       #     #         # #   #       # # # # #         #
### ### ##### # ### # ##### # ############# # # # # ####### ######### # # ### ###
#   #       # #   # #   #   #   #           # # # # #               # # #   #   #
# # ### ####### ### ### ### # # ################# # # # # ### # ##### # # # #####
# #   #     #     # #     # # #                 # # # # # #   #   #   # # #     #
### ##### ####### # # # # ####### # ####### # ##### ####### # ### ### # ##### ###
#     #         # # # # #     #   # #       #   #       #   #   #   # #     #   #
# ### ### ######### # # ### ########### ##### # ### ### ### # # ### # ##### # # #
#   # #       #     # #   #       #     #     # #   #   #   # # #   # #     # # #
### # # # ######### # # # # ########### ######### # ### # ####### ### # ### ### #
#   # # # #         # # # #     #             #   # #   # #         # # #     # #
# # ##### ### ##### # ######### ####### # # ### ##### # # # # # ### ### ### ### #
# # #     #   #     #       #   #       # # #   #     # # # # # #   #   #     # #
####### ######### ### ####### ##### ### # # ### # # ##### # ####### ### ### #####
#             #   #     #       #   #   # # #   # #     # # #         #   #     #
# # # ##### ### ### ### ### ### # ### # ### # # # ### # ### # # # ### # ### # # #
# # # #     #   #   #     #   # # #   #   # # # #   # # #   # # #   # # #   # # #
### ### ########### # ### ######### # ### # # # # ####### # # # ### # # ### # ###
#     #           # #   #         # #   # # # # #   #     # # #   # # #   # #   #
# # ### ############# ##### # # # # ### # # ######### ### ### ######### # # ### #
# #   #         #     #     # # # #   # # #   #         # #     #       # # #   #
##### ### # ### # ### ##### # ##### ### ######### ####### # ##### # # # ### ### #
#       # # #   # #   #     #     # #     #       #       #     # # # # #   #   #
# ### # # ########### # # # ##### # # # # # ####### # ### ##### ### # # ### # # #
# #   # #   #         # # #   #   # # # # #     #   #   #   #   #   # # #   # # #
# # ### ### ### ##### ### ####### # ### # ### # ### ### ### ##### ####### ### ###
# # #   #   #       # #     #     # #   # #   #   #   # #   #           #   #   #
# # ####### ########### # # # ### # # # ### ### ### # ### ####### ##### ####### #
# #     #         #     # # # #   # # #   # #     # # #   #           # #       #
# ### ####### # # # ### ######### ### ########### ### # ####### # # # ##### ### #
#   #   #     # # #   # #           #   #         #   #       # # # # #     #   #
### ####### # # # ##### # ### ### # # # ##### # # ### # # # ##### # ### # # ### #
#   #       # # # #     # #   #   # # #     # # #   # # # # #     # #   # #   # #
# ### ##### ####### # # ##### ######### ##### ##### ####### ####### # ##### ### #
# #   #         #   # # #     #             #   #         #   #     #     #   # #
# ######### # ### # # ##### # ### ### # ### # # # ### ### ##### # ##### # ##### #
#   #       #   # # #     # #   #   # # #   # # #   # #   #     # #     #     # #
### ### # ### # # # # ##### ### ####### # # # # ### # ### # # ####### ### # ### #
#   #   #   # # # # #   #   #         # # # # #   # #   # # #       # #   #   # #
################### #############################################################

