############################# ###################################################
#                                                                               #
# ##### ########### ### # ### ### # ##### ##### # ##### ### # # ### ### # # # # #
# #     #             # #   #   # #     #     # # #     #   # # #     # # # # # #
### ##### ##### ### # # # # # ####### # # # # ############# ####### # ### ### # #
#   #       #     # # # # # #   #     # # # #     #             #   # #   #   # #
# # # # # ### ### ##### # # ### ### ### ### # ####### ### # ### # ### # # # # # #
# # # # #   #   # #     # # #   #   #     # #     #   #   #   # # #   # # # # # #
### ##### ### ##### # ### # ### # ############### ####### ##### # # ##### ### # #
#     #   #       # #   # # #   # #                     # #     # #   #   #   # #
# # ######### ############### # ### # ### ##### ##### # # # ##### ### ### # # # #
# #     #       #             # #   # #     #   #     # # # #     #   #   # # # #
### # # ########### # # ### # ### # # ####### # # ########### ### ### # # ##### #
#   # #           # # #   # # #   # #     #   # #           # #   #   # #     # #
# # ##### ### ############# # # ### ##### # # ### # ### # ### # # ######### ### #
# #     # #             #   # # #       # # # #   # #   # #   # #     #       # #
### ##### ########### # # # ### ##### ### ####### ######### # ### ### # ### # # #
#       # #           # # #   #   #     # #             #   # #   #   # #   # # #
### ### ### ####### ####### # ##### # # # ########### ### ##### # # ##### # ### #
#     #   # #             # # #     # # #   #         #     #   # #     # # #   #
# # # # # # ### ### # ####### ##### ##### ##### ### ### # ### # # ### ##### # # #
# # # # # #   # #   #   #         # #     #     #   #   # #   # #   #     # # # #
# # # ##### ### # ### ############### # ##### ####### ### ### ### ### # ### ### #
# # # #       # # #               #   #   #   #         # #     # #   #   #   # #
# ### ### # # # # ####### # ### # ### # ### # ################# ### #############
#   #   # # # # # #       # #   #   # #   # #   #               #               #
# ####### ##### ####### ######### ##### ##### # # # ####### ### ##### # # ### ###
#   #         #       #         #   #       # # # #     #   #       # # # #     #
# ##### ##### ### ### # # # # # # ####### ### ### # # ##### ### # ### ####### # #
# #         # #   #   # # # # # #   #       # #   # # #     #   # #     #     # #
# ### ### ### # ### # ######### ### ##### # ##### # ### # ##### ############### #
#   # #     # #   # #   #       #   #     #   #   # #   #   #     #             #
# ### ########### # ### # # ##### # ### ### ### ######### # # ##### ####### #####
#   #     #       #   # # #   #   # #     # #       #     # # #     #           #
######### ##### # ### ####### # ##### # ##### ### ##### # # # ##### # # # # #####
#             # # #   #       #   #   # #       #     # # # #     # # # # #     #
# # ##### # ### ##### # # ####### ### # ### ### # # ### # ############# # # ### #
# #     # #   # #     # #   #       # # #     # # # #   #           #   # # #   #
# # # # # ### # # # ### ### # ### # # # ### ### # ##### ############### # ##### #
# # # # # #   # # # #     # #   # # # # #   #   #     #   #             # #     #
# ##### # ##### ### # ### ####### ### # ### # ####### # # ##### ##### # #########
#     # #   #   #   # #       #   #   # #   #       # # #     #   #   #         #
### ##### ##### ####### # # ##### ##### ##### ### ######### # # # ############# #
#     #       #   #     # #   #       #     #   #     #     # # #             # #
# ### # # # # ########### ### ### ### ### # ######### ##### ### # ##### # ### # #
#   # # # # # #             #   #   # #   # #           #     # # #     # #   # #
# # # # ##### # # ### # ### ### ### # # # # ### ### ### ######### # ### ### # ###
# # # #   #   # #   # # #   #     # # # # #   #   #   #         # #   # #   #   #
# ############# ### ### ### ### ### # # # ### ####### # # ### ### # # ### # ### #
#   #             # #   #     #   # # # # #         # # # #   #   # # #   # #   #
# # # ##### ##### # ### ##### ####### ### ### ############# # ### ### ### ### # #
# # # #       #   #   #   #   #         #   #       #       # #     # #     # # #
# ##### ####### ### # ### # # ##### ### # ### ########### # ### # # ######### ###
#   #   #       #   #   # # #     #   # #   # #           # #   # #     #       #
######################################### #######################################

