################# ###############################################################
#                                                                               #
# ### ### ### ##### # # # ####### ##### # ### ########### # # # # ### ####### # #
# #   #   #       # # # # #         #   #   # #           # # # # #     #     # #
### ##### ### ### # ##### # # # ##### # ### # ############### # # ##### ### # # #
#   #       # #   #     # # # # #     # #   #       #         # # #     #   # # #
# ##### ##### ### # # ####### ######### ### # ########### # ### # ### # ### # ###
# #         #   # # # #           #     #   #       #     #   # # #   #   # #   #
# # ######### # ### # ### ### # # ### ####### # # ### # ### ### ### # ##### #####
# #     #     #   # # #     # # # #   #       # #   # # #   #   #   # #         #
# ### # ##### # ### # ##### ### # # # ### # ########### ##### # ### ########### #
# #   #   #   #   # # #     #   # # # #   #           #   #   #   #           # #
# ### ##### ### # # # ### ##### # ##### # # # ##### # ##### ### # # # # ##### ###
#   # #       # # # #   #     # #   #   # # #   #   #   #   #   # # # # #       #
# # ##### ########### # # ##### ### ### ### # # # # # # ##### # # # ### ### ### #
# #     #     #       # #     # #     # #   # # # # # # #     # # # #     # #   #
# ##### ### # ### ######### ############# ### # ##### ##### ### # # # # # # ### #
#     # #   # #           #   #           #   #   #     #   #   # # # # # #   # #
# ### ### ##### ### ##### ### # ##### ####### # # ### ####### ### # # ##### #####
# #   #       # #     #     # # #           # # # #     #       # # # #         #
####### ##### # ### ### ####### ##### ########### ### ##### ######### # ### ### #
#         #   # #     # #         #           #     # #           #   # #   #   #
####### # # # # ### # # ### ##### # ##### ##### ########### ####### # # # ##### #
#       # # # #   # # # #   #     # #     #             #     #     # # #     # #
# # ### ### ##### ### ### ### ### ### ################# # # # ### ######### # # #
# #   #   #   #   #   #   #     #   #               #   # # #   # #         # # #
### ### # # # # # # ### ############# ### ##### # # ##### ##### # ### ### ### # #
#   #   # # # # # #   #             #   #     # # #     #     # #   # #   #   # #
### ### # ####### # # # # ### # ######### ##### ##### ##### ##### ### ####### ###
#   #   # #       # # # #   # #         #     #     #     #     # #         #   #
# ### ### ### ######### ### ### # ##### ##### ##### # ##### ####### ### # ### # #
# #     # #           #   #   # # #       #       # # #       #       # # #   # #
### # # ######### # ####### ######### # ##### ### ######### ### # # ##### ##### #
#   # #     #     #     #     #       # #       #   #       #   # # #       #   #
### # # ### # ######### # ### # ####### # # # ##### ######### # # ### ##### ### #
#   # #   # #       #   #   # # #       # # #     # #         # #   #   #     # #
### ### # # # ### # ### ########### # # ### ####### ### # # ### ##### ######### #
#   #   # # # #   #   # #           # #   # #       #   # # #       #     #     #
##### ##### ##### ### ####### ##### ####### # ### # ### ### ##### # ### # ### ###
#       #       # #         #     # #       #   # # #     #     # #   # # #     #
# # ### # # ##### # # # ### # # # ### ### ### ##### # # # ### # ######### ### # #
# #   # # #   #   # # #   # # # #   # #   #       # # # # #   #       #     # # #
##### # # ####### ### # # # ##### # ##### ######### ##### # ####### ### # # ### #
#     # # #       #   # # # #     #     # #             # #       # #   # # #   #
# ##### ####### # ############# # # ### ### # ##### # # # # # # # # ##### ##### #
# #           # #         #     # # #   #   #   #   # # # # # # # # #       #   #
### # # # # ### # ### # ##### # ##### ##### ### ### # ### # # ####### # #########
#   # # # # #   # #   #     # # #         #   #   # #   # # # #       #         #
### # # ### # # ############# # # ####### # # ### ####### ##### # # ### # ### # #
#   # #   # # #             # # #     #   # #   #   #         # # # #   # #   # #
### # ### # ### # # ### ### ### ####### ##### ##### ### ### ### # ##### ####### #
#   # #   # #   # # #   #   #         # #         #   #   #   # #     # #       #
# ### # # # # ### ######### # # # # ### ### ################# # # ### # ### ### #
#   # # # # # #         #   # # # #   #   #             #     # #   # #   #   # #
##################################### ###########################################

