############################################################################# ###
#                                                                               #
# ### ### ####### ### ### ########### ####### ### ### ######### # ####### # # # #
#   #   #     #   #   #       #         #       # #   #         #     #   # # # #
# # # ######### ### ############# ### # # # # ### # ##### ### # ####### # #######
# # #   #         #           #     # # # # # #   #     #   # #     #   #       #
# ######### # ####### # # # # ### ### # ### # # ##### ### ### ### # ### # #######
#       #   #   #     # # # #   # #   # #   # #     # #   #     # # #   #       #
# # # ### ### # # ### # # ### ##### ### # ### ########### ####### ### ### # ### #
# # #   # #   # #   # # # #       #   # # #     #             #     # #   # #   #
####### # # # ### # # # # ### ####### # ####### # ### # ### # ### ### ##### # # #
#       # # #   # # # # #   #       # # #       # #   #   # # #     #   #   # # #
### # # ##### # ### # # # # # ### ### # ### ### # ### ######### ### # # # # # ###
#   # # #     #   # # # # # # #   #   # #     # # #   #           # # # # # #   #
# ### # # # ### # ########### # # ##### ### ##### # # # # # # # # # ##### ### # #
#   # # # #   # # #           # #     #   # #     # # # # # # # # #     #   # # #
# # ### # ### # ####### # ##### ### # ########### ### ### ### ####### # ### ### #
# # #   #   # #     #   #   #     # #     #       #     # #   #       # #   #   #
# # # # ### ##### # ##### ####### # ##### ### ### ####### # # # ### # ### # #####
# # # # #       # #   #         # #   #   #   #         # # # #   # #   # #     #
### # ######### ### ### # # ### ### # ### ########### # ####### ##### ######### #
#   # #           # #   # # #     # #   #         #   # #       #         #     #
# # # # # # ##### # # # # # # ### ### # # # # ##### # ####### ### ########### ###
# # # # # #   #   # # # # # #   # #   # # # # #     #       #   #     #         #
# ######### # # # ### # ### ####### # ##### ### # # ##### ####### # ##### ### # #
#   #       # # # #   # #         # #     # #   # #   #         # # #       # # #
# # # # # # # ### # # # # ####### ##### ##### # # # ### ### ### ### # ##### # # #
# # # # # # # #   # # # # #       #         # # # # #   #     # #   #   #   # # #
# ### # ### ####### ### # # ####### ### # # # ### ### # ### # # ######### ##### #
#   # #   #     #   #   # # #       #   # # #   # #   #   # # #       #   #     #
# ### ####### # # ##### # ### # # # # ##### # # # # # ### # ##### # ########### #
#   #       # # #     # #   # # # # # #     # # # # #   # #   #   # #           #
# ### ### ##### # # # # # # # # ##### ####### ######### ##### # # # # ##### # # #
#   # #       # # # # # # # # # #           #     #       #   # # # # #     # # #
# # # # ### ### # ######### ### ### # ##### ####### ######### ### # # ##### # # #
# # # # #   #   #         # #   #   # #           #     #     #   # #     # # # #
# ######### ### ####### ### ####### ### # ####### ####### ### # # # # ##### ### #
#       #   #       #   #       #     # # #             #   # # # # #     #   # #
# # # ### ##### ### ### ##### ####### ### # ##### # # # # ##### # # ##### # # ###
# # # #     #     #   #     #       #   # # #     # # # #   #   # #   #   # #   #
# # # # # ### ### # # # ### ##### ### ### ### ####### ######### # ### # ### # # #
# # # # #   # #   # # # #       #   #   # #     #     #         #   # # #   # # #
####### # # # ### # ### # ### ### ### # ### # # ### # # # ########### ##### #####
#       # # #   # #   # #   #   #   # #   # # #   # # # #     #           #     #
### ### ##### ### ##### # ### ####### ########### ##### ##### # # ##### # ##### #
#   #       #   #   #   #   #   #         #       #         # # #     # # #     #
### # # # # # ### ####### ### # ### # ##### ################# # ### # # # # ### #
#   # # # # # #       #     # # #   # #                     # # #   # # # # #   #
### # ####### ##### # ##### ##### ### # # ####### ### # # # # # # ### ##### ### #
#   #     #     #   # #     #     #   # # #         # # # # # # #   # #     #   #
# ### ### ##### ####### ####### # # # ####### ####### # # # ### ##### ### # # # #
#   # #   #     #           #   # # # #           #   # # #   #   #     # # # # #
# ######### ##### # ####### ##### ### # ### # # ####### # ##### ### ### # ##### #
#       #   #     # #           # #   #   # # #       # #     #   #   # #     # #
####### #########################################################################

