######################################################### #######################
#                                                                               #
# ### ######### # # ############# ####### ### # ### ##### ### ### # # # # ### ###
#   # #         # #   #             #       # #   #   #     # #   # # # # #     #
# ##### ### ### ### ### ### # # # # ### ##### ##### # # ##### ##### ### ####### #
#   #   #   #   #   #     # # # # # #       # #     # #     #   #   #         # #
### # ### ##### ### # # # # # ### ####### ####### # # # # ### ##### # # ### ### #
#   #   #   #   #   # # # # #   # #             # # # # # #       # # #   # #   #
# # ### # # ##### ##### ### ### # # # # ### # ####### ########### ### # # # # # #
# #   # # #     #     #   # #   # # # # #   #   #     #             # # # # # # #
# # ### # # ### ##### # ### ####### ######### ##### # # ##### # ####### #########
# # #   # # #   #     # #       #         #     #   # #     # #     #           #
### # # ######### ### # # ### ####### ##### # # # # ### ##### ### ### ### #######
#   # #         #   # # #   #       #     # # # # # #   #     #     #   #       #
# ##### ##### ### # # # # # # ####### ##### ####### # # # ### ### ### ##### # # #
# #         # #   # # # # # # #         #     #     # # #   # #     # #     # # #
# ####### ### ######### # # ### # # ### ######### # # ##### ####### ##### # ### #
#       # #         #   # #   # # # #   #         # # #         #       # #   # #
# # ##### # ### # # ##### ########### ##### # ### # # # # ### # ### # ####### ###
# #   #   #   # # #   #     #           #   #   # # # # #   # # #   # #         #
# # ##### ### ### # ##### ####### # ### ##### ##### # # ##### # ######### # ### #
# #   #   #     # #   #         # #   #     #     # # # #     #         # #   # #
# # # # ### ######### ##### # # # # # ### ########### ### # # # # ##### ### ### #
# # # #   # #             # # # # # #   #           #   # # # # #   #     # #   #
### ### ### # ##### # # ### # # ####### # # ####### ### # ### # # ####### # # # #
#     #   # # #     # #   # # #       # # #     #   #   # #   # #   #     # # # #
########### ##### # # # ### ##### ############# ##### # # # # # ### ### ### # # #
#             #   # # # #     #       #             # # # # # #   #   # #   # # #
# # # ### ### ##### # # ######### ##### # # ##### # ##### # # # ### ####### # # #
# # #   #   #   #   # #   #         #   # #   #   # #     # # #   # #       # # #
### ############# # ####### ### ### ### # ############# ### ########### # # #####
#               # # #       #   #     # #             # #             # # #     #
### ######### ### ### ##### # ### ### # ### ##### # # # ### ### ### ### # # # # #
#   #         #     #     # #   # #   # #   #     # # #   #   # #     # # # # # #
### ##### # # ####### # # # ######### ### ### ####### ######### ### # ##### ### #
#       # # # #       # # #   #       #   #         #         #   # #   #     # #
### ### ### # ##### ##### # # # ### # # ### # ##### # # ### # # ### # # # ##### #
#     #   # # #         # # # # #   # # #   # #     # #   # # #   # # # #     # #
### ### ### # ##### ################# ######### ##### ### # # # ### ### # ##### #
#   #     # # #               #               #     # #   # # # #     # #   #   #
# ### ####### # # ### # ### ### # # # # # # ##### # # # # # ### # ### ### ##### #
#   # #       # #   # # #     # # # # # # #     # # # # # # #   # #   #   #     #
##### # ########### # ### # # ##### ####### ####### # # ### ##### ##### ####### #
#     #           # # #   # #     # #         #     # # #   #     #           # #
### ####### ####### ### # ####### # ### # ### ##### ######### ### ##### ### # # #
#         #       #   # #   #     #   # #   # #       #         # #     #   # # #
### ##### # # ##### ### ### ### # # # ### # # ### ### # ####### ### # ### # # ###
#       # # # #       #   # #   # # # #   # #   # #   #   #       # #   # # #   #
# ########### ##### # # # # # ############# ### ####### ##### ##### ##### ### # #
#   #             # # # # # # #             #   #       #     #     #       # # #
# # ##### # # ### ############# # ### # # ### # ### # ### ### # # ### ### # ### #
# #   #   # #   # #             #   # # # #   # #   # #   #   # # #     # #   # #
# # ### # ##### ##### # ### ### # ### # ##### # ### ########### # ### # # ### # #
# #   # #     # #     # #     # # #   #   #   # #         #     #   # # #   # # #
############################################################# ###################

