##################################################################### ###########
#                                                                               #
# # ### ### # # ### # # ### ### # # # # ### ######### # ####### # ####### ##### #
# # #     # # #   # # # #   #   # # # # #           # #       # #   #       #   #
# ### # # ### # # # # # ### # # # # # ### # ### ### # # # # # # # ### ##### ### #
#   # # #   # # # # # # #   # # # # #   # #   # #   # # # # # # # #     #     # #
### # ######### # ### # ### # ### # # ### ### ##### # # ####### # # # # ##### # #
#   #         # #   # # #   #   # # #   # #       # # # #       # # # #     # # #
# # ##### # ### ##### # ### ### ##### # ### ### # ### ######### ### # # # # # ###
# #     # # #     #   # #   #     #   #   # #   # #     #       #   # # # # #   #
### # # ##### # # # ##### # # ### ##### # # ### # # ### # # ### ### # ##### ### #
#   # #   #   # # #     # # # #     #   # #   # # #   # # #   # #   #     #   # #
# # # ##### ### # # ######### ####### ### ####### # ### # ### ### # # ######### #
# # #   #   #   # # #           #       # #       # #   #   # #   # # #         #
# # # ### ### ##### ### ##### ### ####### # # # ##### # # ####### # ### ##### ###
# # # #     #     #   #   #   #         # # # #     # # #       # #   # #       #
# # ### # # # # # ##### # ### ####### ############### ### ### ######### ##### ###
# # #   # # # # #     # # #   #                     #   # #       #     #       #
### # ### # # # # ### ######### # ##### # ##### ########### ### ### ########### #
#   # #   # # # #   #         # #     # #   #         #     #     #       #     #
# # # ### # ######### ### # # # # # ### ### ### ### ### # ####### ##### # ##### #
# # # #   #       #   #   # # # # #   # #     # #     # #     #       # #     # #
# ##### # ### # ############# ### # # ### ################### ##### ### ##### ###
# #     #   # # #               # # # #       #               #       #   #     #
### ####### ### ##### # # ### ##### ##### ### ####### ####### ### ### # ### # # #
#       #   #       # # # #     #     #   #         # #       #   #   #   # # # #
### ############# # # ##### ### # ####### # ##### ####### # # ######### # # # ###
#   #             # # #     #   # #       #   #   #       # #       #   # # #   #
# ##### ##### # ### ######### ##### # # # ### # ### ### ### ### # # ### # ### # #
# #         # # #         #   #     # # #   # # #   #     # #   # # #   # #   # #
# # ####### # ### ### # ##### ### ### # # # # # ### # ### # # ####### # #########
# # #       # #     # # #     #     # # # # # # #   #   # # # #       #         #
# ##### # # ##### ### ##### # # ### ##### ##### ### ######### ### ####### #######
#   #   # #   #     # #     # # #   #     #     #           # #     #           #
### # # # ##### # # ##### # # # ### # # # ### ##### ########### # # ### # ##### #
#   # # #     # # #     # # # #   # # # #   # #           #     # #   # # #     #
### # ### ### # # # ### ### ### ##### ##### ####### # ##### ########### # ##### #
#   # #     # # # #   # #   #     #     #         # #     #         #   #   #   #
# # # ### ### # ### ### ### # ######### # ####### # ##### # ### # ####### ##### #
# # # #     # # #     #   # #   #       #       # #     # #   # #       #   #   #
# # ####### ### ### ### # ### # # ##### ########### # # ##### ### # ### # # # ###
# #     #     # #     # # #   # #     #     #       # #   #     # # #   # # #   #
# # # # ### ##### ### ### # # # ##### # # # ##### # ### ### ### # # ### # # ### #
# # # # #   #       # #   # # # #     # # #     # # #   #     # # # #   # #   # #
# # # ##### # # # ### # # # # ##### # # ####### # ####### ### ######### # ### ###
# # #   #   # # # #   # # # #   #   # #       # # #         # #         #   #   #
# # # ### # # # # ####### # ### ### # ######### # # ##### ####### # # # # # # # #
# # # #   # # # #   #     # #   #   #   #       # #     #       # # # # # # # # #
# # # ### ######### # # ####### ### ### # ### ##### ### # # # ### # # ##### ### #
# # #   #   #       # # #         #   # #   #   #     # # # # #   # #     #   # #
# # ####### ##### ##### # ##### # ##### # # # ### # ### # ############### ### ###
# # #         #     #   #     # # #     # # #   # # #   # #                 #   #
# ### # # ### # ### # # ### # ##### ### ####### ### ### ### ##### # ##### # # # #
#   # # #   # # #   # # #   #     #   #   #     #   #     #     # # #     # # # #
### ### # # ##### ####### ### # # # ### # # ########### # # ### # ######### #####
#   #   # #     #     #     # # # # #   # #     #       # # #   #       #       #
####################################################### #########################

