############################################################### #################
#                                                                               #
# ### ### # # ##################### ### # ### ### # # ######### # # ##### ### # #
# #     # # #     #                 #   #   # #   # #         # # # #     #   # #
# ### ### ##### ### ### # ####### ######### ##### # ### # # # ##### # ### # # # #
# #   #   #       #   # #     #       #         # #   # # # # #     # #   # # # #
### # # # ### # # # ######### # # ### ### # ####### ####### ##### # # # ### ### #
#   # # # #   # # #   #       # # #     # # #             #   #   # # #   # #   #
##### ### ##### ##### ##### # # ##### ####### # # ##### ### # # ### ##### ### ###
#       #   #       #     # # #   #       #   # #     # #   # #   # #       #   #
# ######### # # ##### # ### # # # # # ### # ####### # # ### # ### ####### ### # #
# #         # #   #   #   # # # # # #   # # #       # # #   # #         # #   # #
# # # # # # ### ### ### ### ######### # # ### ####### # # ### # ### ######### # #
# # # # # #   #   #   #   #       #   # # #     #     # #   # #   # #         # #
### ##### # # ######### # ### ### # # ####### ### ##### # # # # # ### ##### # # #
#   #     # # #         # #   #   # #       #   #     # # # # # # #       # # # #
# # # ##### ######### ######### # # # ### ### ####### ### ######### ##### ### # #
# # #   #       #             # # # #   #   # #       #       #     #     #   # #
# ### ### # # # # ### ### ### # ##### ######### ############# # # # # # ### ### #
#   # #   # # # # #     #   # #     #         #           #   # # # # #   # #   #
# ### # # ### ##### ##### ### # # ### # ##### ### # ### # # ####### # # # #######
#   # # # #     #       #   # # # #   # #     #   # #   # #       # # # #       #
# # # ### ##### ### # # # ### ### # # ### # # # ######### # # ### # # # # # ### #
# # # #     #     # # # # #   #   # # #   # # #       #   # # #   # # # # # #   #
####### ##### ### # # ####### # ####### ##### # ### ### # # # ### ##### # ##### #
#       #       # # #       # #     #     #   # #   #   # # # #       # # #     #
# ##### ### ### ##### ### ##### # ### # # # ### ### ### ### # # # # # ### ### # #
#     # #     #   #     #     # # #   # # #   #   # #   #   # # # # # #     # # #
# # ##### # # # # # ######### # # ##### ##### ##### # # # # ### ### ########### #
# #   #   # # # # #   #       # #   #   #     #     # # # #   # #         #     #
# # # # # # # ### # ### ##### ##### # ### # ### # ##### ### ### ############### #
# # # # # # #   # # #     #     #   #   # #   # # #       # #                 # #
# ####### ### ### ##### ### # # ### ### # ### ### # # # ##### ##### ####### ### #
#       # #     # #       # # # #   #   #   # #   # # # #         # #         # #
# ##### ### ### ### # # ##### ####### ##### ### # # # # # # ### # # ######### # #
#   #   #   #   #   # # #     #       #     #   # # # # # # #   # #   #       # #
# # # ### ##### # ##### # ### # # ### # ############# # ####### ### ####### # # #
# # #   #     # #   #   #   # # #   # #       #       # #         #     #   # # #
# # # # # ### ####### # # ##### # ### ##### # ##### ##### # ### ##### ### # # # #
# # # # # #         # # #     # #   #     # # #         # #   # #       # # # # #
# ##### # ##### # ##### ### # # # ########### ####### # ### # # # # # ####### # #
#     # #     # #     #   # # # #       #           # # #   # # # # # #       # #
##### ####### ########### # ##### # # # # ##### ### ##### # ### # # ### ### ### #
#           #   #         #     # # # # #     #   # #     #   # # #   #   # #   #
##### ##### ####### # ##################### ### # ### ############### # # ### # #
#         #   #     #   #                   #   # #               #   # #   # # #
### ### # ##### # # # ### # # ### ##### # # # # ##### ### ### # ############### #
#     # #   #   # # # #   # #   # #     # # # #     #   #   # #         #       #
# ### ### ######### # # # ### # ##### # ##### # ### # # ####### ### # ### # ### #
#   # #   #         # # # #   #   #   #     # # #   # #   #     #   #   # #   # #
# # ### # # # ### # # ### ##### ##### ##### # ### # # # # ##### ### ### ##### # #
# # #   # # #   # # # #     #       #     # #   # # # # #   #   #     #   #   # #
# # ### # ######### ##### ####### # # ### # ### # ### # # # # # ##### ##### # # #
# #   # #         #   #     #     # #   # # #   # #   # # # # # #         # # # #
# ### # # # # # ### ##### ####### ##### # # # ######### # # ######### ### # # ###
#   # # # # # #   # #         #     #   # # #       #   # #     #     #   # #   #
######################################################################### #######

