####################################### #########################################
#                                                                               #
# # # # ########### # ##### # # ### # # # # ##### # # # # ### ### ### # ### # # #
# # # #       #     # #     # #   # # # # # #     # # # #   #   # #   #   # # # #
# ####### # # ####### ############# # ### ### ### # # # ### ### ### # # ### # # #
#     #   # # #                   # #   #   # #   # # #   #   #   # # # #   # # #
########### # ######### # ##### ####### # # ### ##### ##### ####### # ### ### # #
#           #         # #   #     #     # #   #   #     #     #     # #     # # #
# # # # # ##### # ##### # ##### # # ##### # # # ##### ##### ### # ##### # ### # #
# # # # # #     #   #   #     # # #     # # # # #     #       # #   #   #   # # #
### ### # ####### ### # ##### ### # ### # # # # # # ####### # # # ##### # # #####
#     # #     #     # #     #   # # #   # # # # # #       # # # # #     # #     #
# # # ### # ########### # ### ### # ##### # # # ##### ### ### # ##### # # # ### #
# # # #   #     #       #   # #   #     # # # # #       # #   #     # # # #   # #
### ######### # # # # # # # # # # # # # ############### ### # ####### # ##### # #
#         #   # # # # # # # # # # # # #             #     # #     #   # #     # #
### ##### ### # ### # # # ### ####### ### ### ### ### ##### ### # ##### # #######
#     #   #   #   # # # #   #       # #     #   # #       # #   # #     #       #
# # ####### # # ##### ### ##### # # # # # # ### ### ### ####### ### # # ### #####
# #       # # #     #   #     # # # # # # # #     # #     #       # # # #       #
# ### # ### ### ### ######### ################### ####### ### # ### ####### # ###
#   # # #   #     # #             #                   #   #   #   # #       #   #
# ### # ####### # # ### # ####### # ### # ### ### # # # # # # # ######### # ### #
# #   #   #     # # #   # #       # #   # #   #   # # # # # # #         # #   # #
### ### # # # # ### # ######### ####### ### ####### # # # # # # # ##### ####### #
#     # # # # # #   # #             #   #         # # # # # # # # #           # #
# # ### ####### # # ### ### ### # ########### ### # ### # # # # ##### # ##### # #
# # #       #   # # #   #   #   # #             # #   # # # # # #     # #     # #
# # ### ####### ##### # # ##### # ### ##### ### # ### ##### # # ### ####### ### #
# #   #     #   #     # #     # #   #   #   #   #   #   #   # # #     #     #   #
# # ### ### ### ##### ####### ### # ##### ##### ######### ### ##### # # # ##### #
# # #   #     #     #       #   # # #         #       #   #       # # # # #     #
# # # ### # ### ### ##### ############# # # # # # ### ### ##### ### # # # # # # #
# # # #   # #   #   #       #           # # # # #   # #       # #   # # # # # # #
# ### ##### ##### # # # # # ####### # ### # ### ##### ################### ##### #
# #     #   #     # # # # # #       #   # # #     #     #                 #     #
######### ########### ####### # # ### ####### ##### ### ##### ### ### ####### ###
#           #             #   # #   #   #     #     #     #     #   #   #       #
# # ####### ### # # # # # ##### ### # ####### ### # # # ### ### ##### ### # # # #
# #       # #   # # # # #     # #   #     #     # # # #   #   # #       # # # # #
# ### # # ##### ### # # # ### # ### ### # # # # ### # ### ##### ### # ### # # # #
# #   # # #       # # # #   # # #   #   # # # # #   #   # #     #   #   # # # # #
# # ### ### ####### # ##### # # # ### ### # # ### ##### ####### # # # ### ##### #
# # #     # #       #     # # # #   #   # # #   #     #   #     # # # #     #   #
# ### # ### # # # # # # ####### ##### # # ### ### ### # # ### ### # ##### ##### #
#   # #   # # # # # # # #           # # # #     #   # # #   #   # #   #     #   #
### # # ### ### ######### # ### ##### ### # ### ##### # ### ##### ####### # # # #
#   # # #   #       #     # #     #   #   # #     #   # #     #       #   # # # #
# ### # # # ##### # ########### ##### # # # # ### ######### ##### # ### ### ### #
#   # # # #   #   # #               # # # # # #       #         # # #   #     # #
### # # ####### # # ####### # ### # # ####### # # # # # ##### ### ########### # #
#   # #       # # # #       #   # # #   #     # # # # # #       #     #       # #
# ### ####### ##### # # # ##### ### ####### ##### # # # ############# # ##### ###
# #     #         # # # #   #     #     #     #   # # #             # #     #   #
# # # # ######### ####### # ### ######### # # ### ##### ####### # ##### ### # # #
# # # #         # #       # #   #         # #   # #         #   #     # #   # # #
######################################################################### #######

