######################################### #######################################
#                                                                               #
### ##### # # # ### ##### # ### ######### # # ### ##### # # # # # # # # ### #####
#       # # # # #       # # #       #     # # #   #     # # # # # # # # #       #
# ####### ##### ### # # # ### ### # ##### ####### # ##### ##### ### ##### # # # #
#     #     #     # # # # #     # #   #         # # #         #   #     # # # # #
# # # ### # # ### ### # ### # ####### ### # ##### # ### ### ### ### ### # # #####
# # # #   # #   # #   # #   #       # #   #   #   #   #   #   # #     # # #     #
# # ######### ##### ### # # # # ### # ### ##### # # ##### ##### # # ##### # # ###
# #     #       #     # # # # # #   # #   #     # # #       #   # #     # # #   #
# # # ########### ##### # ### # ### # ####### ####### ##### ### ####### ##### # #
# # #   #             # #   # #   # #     #         # #     #         # #     # #
# # ### # ##### # # ### # ### # ### # ### ####### ####### # ### ##### # ##### ###
# # #   #     # # # #   # #   # #   # #         # #       #   #     # # #       #
# ##### # # ### # ####### ####### # ####### ### ##### ### ########### # ### # ###
#     # # # #   # #           #   #       #   #     #   #           # # #   #   #
# ### # # # ### # ### ### ####### ### ########### ##### # # # # # # # ######### #
#   # # # # #   # #   #       #   #         #         # # # # # # # #         # #
# ### # ### ##### # ### # ####### # # # ####### # # ### # # # # ### # ####### # #
#   # #   #   #   #   # #     #   # # # #       # #   # # # # # #   #   #     # #
### # ### ### # # # ### # ##### ### ### # ##### # # # ### ########### ######### #
#   # #     # # # #   # #     # #   #   #   #   # # # #       #         #       #
# # ### ### ### # ### # # # # # # # # ### ### ########### ### # # ### ### ### # #
# # #     # #   # #   # # # # # # # # #   #       #         # # #   #   # #   # #
# ##### ######### ### # # # ####### ### ### # # ### # # # ### ### ### # # ##### #
#     # #         #   # # #     #     # #   # # #   # # # #   #   #   # #   #   #
# ### ### # ######### # ### ##### ##### ##### ### # ### # ##### ### # ### # ### #
#   #   # #     #     #   #     #     # #     #   #   # #     # #   #   # #   # #
# ####### ### ### ####### ####### # ### ### ####### ### # ### # ### # ######### #
#       # #     # #       #       #   #   #       #   # # #   #   # # #         #
# ### ####### ##### ### # ### ##### # # # ##### ### ### ### # # # # ####### ### #
#   #       # #       # #   #   #   # # #     # #   #     # # # # #       # #   #
# # ##### ##### # ### # ### # # # # ######### # # ##### ######### # # # # # # ###
# # #         # #   # #   # # # # # #         # #   #       #     # # # # # #   #
### # ####### ####### # # # ### # # # # # ### # # ### ########### ######### # # #
#   # #             # # # #   # # # # # #   # # #   #           #     #     # # #
### ##### ### # ### ### # # # # # # ### # ### # # ### ##### # ### ### # # ### # #
#   #       # #   # #   # # # # # #   # #   # # #   #   #   # #   #   # #   # # #
# # ##### ############# ######### # ####### ### # # ### # # # # # # # # # # # ###
# # #                 #     #     #     #   #   # #   # # # # # # # # # # # #   #
### ####### # # # # ### ### # ### ### # # ####### ####### # # # # # ### ##### # #
#   #       # # # # #     # #   # #   # #     #   #       # # # # # #       # # #
# ######### ### # # ##### # ##### # # # # # # # # ####### # ####### # # ####### #
# #           # # #     # #     # # # # # # # # #   #     #       # # #   #     #
# ### ########### ### # ####### ####### ##### ### # ########### ######### # # ###
# #   #           #   #     #       #       # #   #   #                 # # #   #
# # # # ##### ### # ### # # ############# # ### # # # ### ### ### ##### # # #####
# # # #   #     # # #   # #           #   #   # # # #   # #   #   #     # #     #
# # # ### # # # # ### ### # ### # ####### ######### ### ### ####### ####### ### #
# # # #   # # # #   #   # #   # #   #             # #     # #             # #   #
# # # # ##### ### ##### ### ##### # ### ##### ####### # ### # # # ### ### ##### #
# # # #   #     # #       #     # # #   #           # # #   # # # #   #       # #
# # ### # ################### # ####### ### ##### ##### # # ### ########### # # #
# # #   #     #               #     #     # #         # # #   #         #   # # #
# ### ##### ### ### # ### ##### ####### ##### ### ####### # # ### # # # ##### # #
# #     #     #   # #   #   #         #     # #         # # #   # # # # #     # #
############################### #################################################

