################################################################# ###############
#                                                                               #
# ### ### # # ### ### # ### ####### ####### ####### # ### # ### # # ##### ##### #
# #   #   # # #     # # #   #         #           # # #   #   # # # #       #   #
# # # ### # # # # ### # ### ##### ##### ####### # ####### # ####### ####### ### #
# # #   # # # # # #   # #       #   #     #     #     #   # #             # #   #
# # ####### # ### # # # # ### ############### # ##### # # # ##### ####### ##### #
# # #       #   # # # # # #     #             #   #   # # #     # #           # #
##### ### ### ####### # # ##### # ##### # ### ##### ######### # ### ######### ###
#     #   #       #   # # #     #   #   #   #     #     #     #   #     #       #
# # # ### # ### ##### ### ########### # # ### ### # # ### ### ##### ##### ### ###
# # #   # #   #   #     #   #         # # #     # # #   #   #   #     #     #   #
# ### # ### ### # # ### ######### ### ### # # # # # ### ### # ### # ####### # ###
# #   #   #   # # # #         #     # #   # # # # # #     # # #   #     #   #   #
# # # ### # # ### ##### # # # # ### # # # # # # # # # # # # ####### # ##### # # #
# # #   # # # #     #   # # # #   # # # # # # # # # # # # #     #   # #     # # #
# ##### ########### # # # # ############# ### # # ### ########### ### # # ##### #
#   #       #       # # # #     #           # # #   # #             # # #   #   #
# ##### # ######### # ### ### ##### ### # ### ######### # # ####### # # ### # # #
#   #   #     #     #   #   #   #   #   # #         #   # #   #     # # #   # # #
### # # # # ### # # ##### ### ### ##### ### ######### ####### ### # ######### # #
#   # # # # #   # # #     #     #   #   #         #   #         # # #         # #
# # # ##### # ### ### # # # # ### ####### ##### ############### ### ### # # # # #
# # #   #   #   # #   # # # # #       #     #   #                 # #   # # # # #
# ### # ### # ####### # ### ############### ######### ####### ### ### # # # # ###
# #   # #   # #       #   #   #                     # #       #     # # # # #   #
# ### ##### ##### ### # # ### ##### # # # ### ### ######### ### # ##### # # # ###
# #       #   #   #   # # #     #   # # # #   #         #     # # #     # # #   #
##### # ### ######### ####### # ##### ##### ######### ### ### # ### ##### ##### #
#     # #   #             #   # #     #     #           # #   # #       #     # #
# # # # ### # ### ##### # # ##### # ##### ### # ### # ####### ### ######### # # #
# # # # #   # #   #     # #     # # #       # #   # #       # #         #   # # #
### ### ### # # # ### ####### # # ####### # ##### # ### ####### ### ### ### #####
#     #   # # # # #         # # #   #     # #     #   # #       #     #   #     #
# # # # # ####### # # # ####### # # # ### ### # ### ### # # ### # ##### ### # # #
# # # # #   #     # # #       # # # # #     # # #     # # # #   # #       # # # #
####### ### ### # ### # ##### # # # ##### ##### # ### ####### # ### # # # ##### #
#         # #   # #   #     # # # #   #     #   # #     #     #   # # # #     # #
# # # # ### ### # # # # ### # # # ##### ### ### ##### ####### ##### ### ##### # #
# # # # #     # # # # # #   # # # #       #   # #           # #     #     #   # #
##### # ########### ### # ### ### ### ######### ####### ### # # # ##### ####### #
#     #   #           # #   #   # #           # #         # # # #   #         # #
# ##### # ####### # # ##### ### # ##### ####### ### # # ##### ####### ##### ### #
# #     # #       # #     #   # # #       #     #   # # #         #       # #   #
# # ### ### # ####### # ### # ### ##### ##### ### ##### ##### # ######### ##### #
# #   #   # #   #     #   # #   #     #   #     # #     #     # #           #   #
# ### ### ######### # # ##### ### ### # # ### # # # ### # ####### # ### # # ### #
#   #   #   #       # # #     #   #   # #   # # # # #   #     #   # #   # # #   #
# ##### ####### # ### ####### ##### # ### ##### ### ### ### # ##### # ### # #####
#   #   #       # #         # #     # #   #     #     #   # # #     #   # #     #
# ####### ### # ### ####### # # # ### ##### ### # ####### # # ##### # ### # # ###
# #       #   # #         # # # # #       #   # #   #     # # #     # #   # #   #
# # ##### ### ####### # ##### # # # ### # # ################### ##### # ### ### #
# # #     #       #   #   #   # # #   # # # #                       # #   #   # #
### # ##### ### # ### # ### ### ### # # # # ### ####### # ##### ### ######### ###
#   #   #     # #   # # #   #     # # # # #   #   #     # #       # #           #
################################# ###############################################

