########### #####################################################################
# #       #   #       #     #   #         #     #   #   #   #   #     # #       #
# ### # ##### ### ### # # ##### ### ### ##### ##### ### # ### ### ### # # # ### #
# # # #     #     # # # #   #         # #           #           #   # #   #   # #
# # ##### # ##### # # # ##### ##### # ### ### # ### ######### ##### # ##### ### #
#     # # # #     #       # #   #   # #   #   # #               #   #         # #
### # # # ### # ### ### ### ### ### # ######### ### # ########### ####### ##### #
#   #       # #   # # #           # # # #     #   # # #       #     #         # #
# ### ##### # ### ### ##### # ####### # ### # # ##### ### ### ### ##### ### ### #
# # # #       # # #   #     # # # #   #   # #   #   #     #   #   #       #   # #
# # # ##### ### ### ########### # # ##### ####### # ### ### ####### # ######### #
# #   # #   #       #   #         #       # #   # #   # # # #       # # #       #
### ### # ######### # ### ### ### ### ### # ### ### # # # # # # ##### # #########
#     # # # # #         # #     # #     # # #   #   # # #   # # #   # #         #
# ### # # # # # ######### ### ##### ####### # ### # ### # # ####### # # ##### ###
#   # #     # #     # #     # #       #   #   # # #   # # # #   #   # # #       #
# ########### # ##### # # ##### ### # # # # ### ### # ### ### ##### # # ##### ###
# #     # #   #         # # #   # # # # #   #       # #           # #     #     #
# # ### # # # # # ### ### # # ### ####### ######### ##### ####### # # ##### #####
#     #   # #   #   #   # #       #   # #     #     #   #     #         #       #
# # ####### ### ######### # ##### # ### ##### # # # # ### ### ######### ####### #
# #     # # #       #   #       #       #       # #     #   #     #     #   # # #
# ### ### ####### ### # ### # ### ### ######### ##### ### ### ##### ####### # # #
#   #           # #   #     # #   # #   #   #   #       #   # #   #   # #       #
# ### ##### ######### # ########### ####### ####### ##### ### ### ##### ### #####
# #     #   #   #   # #   # # #   #   #       #       #   #       #       #   # #
# ### # ####### # ####### # # # # ### # # ### # # ##### ### ####### ### ####### #
#   # #     #     # # # #       #       # # #   #   #     #   #       #     #   #
##### # ##### ### # # # ### # ######### ### ##### ### # ####### ##### # # ### ###
#   # #   #     #   #     # # #       # #     # # # # # # #     # #   # #   #   #
### ##### ### ######### # # ##### ### # ##### # ### ### # ### ### # ####### ### #
#   #       # # # #   # # # #     #   #       #         #   #   # #   #       # #
# # ####### # # # # # # ### ### # ### ######### # # ##### ##### # ##### # ### # #
# # #     # #       #     #     # #   # # #   # # #   #             #   #   #   #
# ### # # # ### ##### ### # # ##### # # # ### # ######### # ### # ### # ### ### #
#     # # # #       # #   # #   # # #   # #             # # # # #   # #   # # # #
### ### ### # # # ####### ##### # # ##### ####### ##### ### # ### ######### # # #
#   #   # # # # #   #       # #   # #     #   # # #     #     # # #     #   #   #
# # ##### # ##### ### ### # # # ### ##### # # # ### ########### # # ### # ### ###
# #       # #   # # #   # #   # #     #   # # #     #           #   #   #   #   #
# ### # ### ### # # ##### # ### ######### # # ### ### ######### # # ### # ##### #
# #   #     #     #     # #           #     #   # #   # # #     # # # # # #   # #
# ### # # # # ### ### # # # ### ##### ### # ### # # # # # ### # # ### # # # ### #
# # # # # # #   #     # # #   #   # #   # #   #   # #     #   #   #     # # #   #
### # ### ######### # ### ####### # # ##### ####### # ### ### ######### # # # ###
#   # # #   #     # # # # #   #   #         #   #   # #   #   #       # #   #   #
# # ### ######### ##### # # ######### ##### ### ### # ##### # # ### ########### #
# #     #     #       # # #         # #     # #     #   #   # # #     # #   #   #
# # ### # ### # # ##### # ##### ########### # ##### # # ##### # ### # # ### #####
# # #     #     # # #       # # #   #   # #       # # #     #   # # #     #     #
### # # ### # ### # ####### # # # # ### # # ############# # ##### ### # ### ### #
#   # # #   # #   #       #       #   #     #             #   #     # #     #   #
# # # ### # ####### # ### # ### ####### ### # ### ####### ### ##### # # ##### # #
# # #   # # #   #   # #   #   #     #     #   #     #     # # #       #   # # # #
# ##### # # # # # # ##### ### ### # ####### ### # # ##### # ### ### # ##### # ###
# #     # #   #   # #           # #       #   # # #   #       #   # #       #   #
################################# ###############################################

