################################### #############################################
# #   #             # #     #   #       #     #   #       #     # # # #   #   # #
# # ### # ##### ### # ### ##### ##### # ##### ### # ### ### ### # # # # ### ### #
#       #   # # #       #   #         #       #   # # #       # #       #   #   #
### ######### ####### ### ### # # ####### ##### ##### # # ### ### ### ### # # # #
#     # #       #   # #       # # # #     #   #   # # # # # # #   #     # # # # #
##### # ### # ##### ####### ##### # # # # # # # ### # ##### # ##### # ##### ### #
# #     # # # # # # #       #   # #   # # # #   # #   #       # # # #     # #   #
# # ##### ### # # # ### ##### # ### # ### # # ### ### # ####### # # ##### # # ###
# # #   #   #     #         # #   # # # #   # # #     #   #         #   #   # # #
# # # ##### # ####### # ##### ######### # ### # # ### # ### # # ##### ### ### # #
#   # #     # #     # #   # #   #   #   # # # #     #   #   # #     #           #
### # ##### # ##### ##### # # # ### # ##### # # ### ##### ########### ### ##### #
# #           #       #   #   #   #   #         # #   #     #       # #   #     #
# # ### ### ### ### # ### # ##### # # # # # ### # ### ### ##### ####### ##### # #
#   #   # # #   #   # #   #   #   # #   # #   #     #     #     #       #   # # #
# ##### # # ##### # ####### ######### ##### # ##### # ##### # # # ### ### # ### #
# #   # # #   # # #   #         #     #   # # # #   #       # # #   # # # #     #
### ##### # ### ##### ### ##### ### ### ####### ##### # ### ####### ### ##### # #
# # # #   # # #   #   # # #   # #   # #   #     # #   #   #     # #       #   # #
# # # # # # # ### # # # # ### ####### # ### # ### # ##### ### ### ############# #
#   #   # # # #   # #     #       #     #   #     # # #     #   # # # # #     # #
# ### ### # # # # ##### # # # ### ### ### # ##### # # # ### ### # # # # # # #####
# # #   #       # # #   # # #   # #       # #   # # #   #   #   # #   #   # #   #
# # ######### ##### ### # # ##### ##### # # # # # ### ######### # ### # ### # ###
#   #             #     # # #   #     # # #   # #   #   # # # #   #       #     #
### # # ##### ####### # ### ### ##### # ### ####### # ### # # ### ##### # #######
#   # # #         #   # #       #     # #   #     # #   #     # #       #       #
# ### # # # ####### # ####### ########### ####### ### # # ### # # ### ### ### # #
# # # # # # #     # # #       #       #       #       # #   #     # # # # #   # #
# # ##### # # ### # ######### # ####### ### ##### ##### # # ##### # # # #########
#       # #   #     #       # # #         # #   # #     # # #       #     # #   #
# ####### ##### ### ##### ### # # ##### ### ### ######### ### ##### ### ### # ###
#     # # # # # #   # #     #   # #   #   # #     #     # # #   #   # # # #     #
### # # # # # # # # # # ##### ### ### ##### # ##### # # ### ##### ### ### ### # #
#   #     #   # # #   #         # # #           #   # # #     #   #   #     # # #
### # ####### # ##### ######### ### # ##### # ##### ####### ### # ### # ##### # #
# # #     # #   # # #     #     #       # # # #   # #   #       # # #   #     # #
# # # # ### # # # # ### ### ### ### ### # # # # ### ### ### ####### # # ### # # #
# # # # #   # #       #       #       #   # # #           #     #     #     # # #
# # # # ### ######### # ### # # # ##### # ### ##### ### # # ##### # # ### ##### #
#   # #   # #     # # #   # # # #   #   # #   #     #   # #       # # # #     # #
# ##### ### ### ### ##### # ########### # ### ##### ##### # ####### ### ##### ###
# #         # # #       # # #     #     # #   #       # # # #   #   #   # #     #
############# # # ######### # ### # ##### ### # ### ### ### ### # ##### # # #####
#   # #   #   #   #   # #   # # # # #       #     #       # #         #         #
### # # # # ##### # # # ##### # # # ### ### ##### ##### ### # ##### # ##### # ###
#     # #   #   #   #         #     #     #     # # # #   # # #     #     # #   #
##### ##### # ### ##### ############### ##### ##### # # # # ####### # ##### #####
#   #             # #       #     #   # # # #       # # #     #   # # # #       #
# ####### # ##### # # ### # ### ### # # # # # # ### # # ####### ### ### # # ### #
# #       #     # #     # # # #   # #   #   # # # #   #       # #     #   # # # #
# # ### # ####### ##### ##### ### # ##### ### # # ### ##### # # ### ### ##### # #
#   #   #     #     #       #           #     # #         # # #     #   #       #
############################################################### #################

