######################################################################### #######
# #     #       #     #     #           #     #         #     # #   #           #
# ### # ### ####### # # ##### # ### ######### # ### ##### # ### ### # # #########
#     #     #   #   #   #   # # #           # # # #     # # #       # #   # # # #
##### ######### # ##### # ### # ### # # # ### ### ### ##### ### ### ### # # # # #
# #   #   #           #   # # # # # # # #     #   #       # # #   #     #       #
# ### ### # ##### # # ##### ### # # ### ######### ### # ### # # ####### ##### ###
#   #       #   # # #     #       # # #   #   # #     # #   #       #       # # #
### # ######### ##### # ####### ### # # ### ### ##### ### # ########### ##### # #
#     #       #       #   #       # #   #     #   # #     # #     # #   #       #
####### # ####### ### # ### ################# # # # ####### # ### # ####### # # #
#       #   #     #   #     #   #     #         # #         # #     # #     # # #
# # # ### ######### ########### ### # # ### ####### ##### ### ##### # # ##### # #
# # # # #   #     #   # # #       # #   # # #     # #   # #   #           #   # #
# # ### # ### ### ### # # ### ### ### ### ### ### ### # # # # # # ####### # ### #
# #   # #   # # #             #   #       # # # #   # #     # # #   #     # #   #
# ##### ### ### ##### ### ### ####### # ### ### # # # # ####### ##### ##### # # #
#     #     # #     #   #   #         #   # # # # # # # # #         #     # # # #
# # ##### # # ### ### ##### ### ### # ### # # # ### ### # ##### ####### # ### ###
# # #     #     #         # #   # # # #               # # #           # # #   # #
############# ### ### # # ### ### ############# # # # # # ##### ########### ### #
#   #   # # #       # # #   #       #       #   # # # #       #   #   #   #     #
# # # # # # ##### # # ##### # # ##### # ### # ##### ####### ####### ### ##### # #
# #   # #     #   # # # # # # # #     #   #     #   #           # #   #   #   # #
### # # # # ### ##### # # # # ### ##### ####### ### ##### ### ### ### ### # # # #
#   # #   #   #     # #     # #   #     #   #   # #       # #   #       #   # # #
# # ### ##################### ### # # # ### ##### ### ##### ##### # # # ####### #
# # #   # # #     # #       # # # # # # # #   #           # # # # # # # # # #   #
# ##### # # ##### # ####### # # ####### # # # ##### ####### # # # ####### # # ###
#     #     #     #   #     #     #   #   # # # # #     #   #       #         # #
####### ####### # # ##### ##### ### ### # # ### # # ### # ######### # # # ##### #
#   #       #   # #     #         #     #       # # #       # # #     # #   #   #
### ##### ### # # # ### # ##### ### ### ######### # ### ##### # # ### ######### #
#       #     # # # # #   # # # # # # # #   # # #   # #       #   #             #
# ### ### ####### # # # ### # ### # # ##### # # ### # # ##### ##### # # ##### ###
# #   #       #     # #         #     # #       # # #     # # # #   # #     # # #
##### ############### ####### # ### # # ####### # ### # ### # # ### ####### # # #
#         #   # # #     #   # #   # #     #   # # # # # #         # #     # #   #
# # ### # # # # # # # ### ### ######### # # # # # # ### ########### # # # ##### #
# # #   #   # # # # # #   #   #         # # #   #   #     # #   #   # # #   #   #
# ### ####### # # ### ### # ### # # ####### # # # ####### # # ####### ### ##### #
# #   #   #   #               # # #   #     # #   #       #     #   #   #   #   #
# ### # ##### # ### ### # ############### # ####### # ##### ##### # ### # ### # #
# #   #   #   # #   #   # # # #       #   #   #   # #     #     # # # # # #   # #
### ### # ### # ##### # ### # ##### # ##### ##### ### ##### # ##### # # ####### #
#       #   #     #   #     #   #   # #       # #           #     #     #     # #
# # # # ####### ####### # ### # # ### ##### ### # # ######### # ### ##### #######
# # # #   # # #     #   # #   #   # #   #         # # #   #   #         # #     #
##### ##### # # ####### ### ### ### # # ####### # # # # # ### ########### ##### #
#       #         # #     #   # #   # #         # # # # # #       # #   #       #
### ### ### ### ### # ### # ####### # ############# # ### # ### ### # ##### ### #
#     # #   #       #   # # # #   # #     #       # #   #   #       #         # #
# ######### ### # ##### ##### # # # # ### ### ### ### ##### # # # # # # ### ### #
# #         #   #   #           #   #   #       #   #       # # # #   # #     # #
################### #############################################################

