####################### #########################################################
# #     #       #       #   #   #       # # # # # #   # #   # #       #       # #
# # ### # ### ### ##### # # ### ##### ### # # # # # ### # ### ### ### ### ##### #
# # # # # # #     #   #   #         # #     #   #     #     # #   # #         # #
# # # ##### ##### # ########### ### # ### # ### # # ### ### # ### # # # ##### # #
#         # #         # #         # #   # #       #   # # #       #   #     #   #
# # ##### # ##### # ### # ### ####### ### # # ####### ### # ######### # ####### #
# # #       #     # #   # #   #     #     # #   #       #     # # #   # #     # #
##### # ### # # # ### # # # ### ####### ### ### ############### # ### ### ### # #
#     # # #   # # #   # # #   # #       # # # # #   #       #   # #   #   #   # #
# ### ### ### # # ### ### ### # # # ##### # # ### ######### # ### ### ##### ### #
#   #   #     # #       # # # #   # #     #       # #   # #     # # #     # #   #
# ### # # ####### ### # ### ##### # ### ######### # # ### ##### # # # # ### # ###
# #   # # #     #   # #     # #   # #   # # # #   # #         #   #   # #   #   #
# ##### # # # ##### ### ##### ##### ### # # # # # # ######### # ### ### ### # ###
#     # # # #     #   # #     #   #   #   # #   #     #     #       # #     # # #
# ### ### # ##### # # # # ##### # ####### # # ##### ##### ### # # ### # ### # # #
# #     # #     #   # # #     # #             #   # #   # #   # # # # # # # #   #
### ##### ########### ### ##### ############# # # # # # # ##### ### # # # # #####
#       #   #         #   #   # #     # # # #   # # # # #           # # #       #
### ####### # ##### ##### ### # # # # # # # ### ### # ### ########### ##### ### #
# # #       #   #           #   # # #   #     #   #   #     #   #       #     # #
# # ##### ######### ### ### ### # ##### ### ### ### ### ##### ### ############# #
#   # # #         # #   # # #   # #         #     #   #         #     # # #     #
### # # ######### ####### ####### ### ### # ### ### # ### # ### # ##### # ##### #
# # #     # #           #   # #   #   #   #     #   # # # #   # # #     # #     #
# # # ### # ### ### ##### ### # ### ####### # ### ##### ##### # # ##### # # #####
#     #       #   #   # # # # # #     # # # #   # #     #     #       #       # #
####### # ########### # # # # ### ### # # # # # # # ##### # # # ##### ####### # #
# # # # #   #   #   #           #   # #     # # # #     # # # #     # #     # # #
# # # ### ##### # ##### ### ##### ######### # ### ### ####### # ### # ### ### # #
#   #   # #     #     #   #         #       #   #         # # # # # # # # #   # #
# # # ####### ### # ### # ############# # ### # ### ####### ### # ##### # # ### #
# #   #   #   # # #   # # #             # # # # #   #     #   #   #   #         #
##### # ### ### # # # # ######### ##### ### ##### ##### # ### # ##### ######### #
#       #       # # #         #     #     #     #       #         #   #         #
### ### # # ##### ### # ##### # # ### # ### # ####### ########### # # # ### # ###
# # #     #         # #     # # #   # #     #   #     #   #   #     # # #   #   #
# ### ### ### ##### ########### # ####### ### # ####### ### ####### # ### ### # #
#     # # #       # #         # #   #     #   #     #         #   # # #   #   # #
# # ### # ####### ######### ########### ####### # ### # ##### ### ### # ### ### #
# #   #         # #   #       #     # # #     # #   # #   #       #   #   #   # #
# # ### ### ######### ### # ### ### # ### ### # ####### # # ##### ### ### # #####
# #   #   #   #           #   #   # # # # #   #   #   # # # #   #   # #   #   # #
# ######### ####### # ##### ### ### # # # ##### ##### # # ### ##### # # ##### # #
#     # #   #       #   #   # # # # #       #   # #     # #       # # # #     # #
# # ### ### # # # ####### ### # # ### # ### # # # ####### ####### # ### ### # # #
# #       # # # # #   # #           # #   # # #   #         #   # # #   # # #   #
# # ####### # ##### # # ##### # # ### ########### ### ####### ### # # ### ### ###
# # #   # #         # #       # # # #         #   #               # # # # # # # #
### # ### ####### ##### ##### ##### # ### ### # ### # # ### # ### ### # # # # # #
# #   #   #     #   # #   #   #     #   # #   # #   # # #   # # # #     # #     #
# # # # ### ####### # # # # ##### # # ### # # # # # # ### ### # ### # # # #######
#   #           #   #   # # #     #     # # #     # #   #   #   #   # #         #
######### #######################################################################

