################### #############################################################
#         #   # #   # #     #             #   # #     #         #       #   #   #
######### # # # ### # # ####### ##### # # ### # # ##### # ##### # # # ### ### ###
#           #     #       #         # # # #           # # #     # # #         # #
# # # # ### ##### ##### # ##### # ### ##### # ##### ### # ### ########### # # # #
# # # # #     #     #   #   # # # #     #   # #         #   #   #   #   # # #   #
# ######### # # ######### # # # # # ################### # ##### # ##### ####### #
# # #       # #         # #     # #         # #         #   #         #   #     #
# # # ### ### ##### # # ### # ### ########### ####### # ##### ####### ### # # # #
#   # #   #   #   # # #     # #               #   # # # #       #   #     # # # #
# # ######### ### ####### ### ### ### ######### # # # ### # # # ### ##### ##### #
# #   #         # #   #   # # #   #   #     # # #   # #   # # # #   # #   # #   #
# ##### # ####### # ### ### # ##### ### ##### ### ##### ##### # ### # # ### # ###
# #   # #       #     #   #   #       # #   #   #     # # #   #     # #   #   # #
# # ### # ##### # # ### ### ##### ##### # ### ### ### # # ### ####### ##### # # #
# # # # #     #   #   # #   #       #             #   #     #     #   #   # #   #
### # ### ### ### ### ######### ##### ####### # ### ##### # # ### # ### # # # ###
#   #   # #     # # #   #               #   # # #         # # # #       # # # # #
# # # ### ### # ### ######### # # # # ### ########### # # ### # # ### # # ### # #
# #     #   # # # #       # # # # # # #   #     # #   # #   # #   # # # #   # # #
### ##### ####### ### ### # # ##### ### # ### ### # ##### # # # # # # ##### # # #
#       #   # # #     #   # # # #   # # # #     # # #   # # # # #   # # # # # # #
##### # ##### # # ### # ### # # ##### # # # ##### ### ### # # ### ### # # ### # #
# #   #           #   #       #         #     # # # #     # #   # # #   #     # #
# # ######### ####### # # # ### ### ######### # # # # # # # ####### # ### ### # #
#       #   # # #   # # # # # # #       #         #   # # #   #     # #   # # # #
### # ##### ### # ####### # # # ### # # # # ### ##### # ### ##### ####### # ### #
#   #         #       #   #   # #   # # # # #     # # # #     # #       #       #
####### ### # # ####### ### ####### # # ##### ### # # ######### ##### ### # # # #
#     #   # # #   # # # # #   #   # # # # #   #     # # #     #           # # # #
### ### ### ### ### # ### ##### # ####### ### # # ### # ### ### ####### ##### ###
#       #       #               # #     #     # #           #     # # # #       #
##### ### ### ### ### ##### ### ### ### ### ##### ####### ##### ### # ####### ###
#     # #   # # #   # #   #   #   #   #     #           # #     #   # #     # # #
# ##### ### ### # # # ### # ########### # ##### ####### # ####### # # ### # # # #
#   # # # #     # # #     # #     # #   # #   # #       #     #   # #   # #   # #
# # # # # # ### # ### ##### # ### # ### ##### # ### ########### ### # # ### # # #
# #       # #     #     #   #   #     # #       #   #           # # # # #   # # #
### ####### ####### ######### ### ######### # # # # ######### ### # # # # ##### #
#   # # #         #             # # #   #   # # # # #   # # # #   #   #         #
# ### # # ### ######### ### # ##### ### ##### ### ### ### # ##### ### ### #######
#   #   #   #   #     # #   #         #       #   #         #   #     #   #     #
# # ### ##### # # # ########### ##### ####### ##### ### ####### ### ##### # # ###
# #   #       #   # # # #     # #       # # #     # # # #   # # #     # #   # # #
########### # ##### # # ##### # ### ### # # # # # # # # # # # # # ### # ### ### #
#         # # #       #     #   #   # # #   # # #     #   #       #     #   # # #
# ### ####### ##### # # # # # ####### # # ### ### ##### ##### ####### ##### # # #
# # # #     # #     # # # # #     #         # # #     #     #       #   # # #   #
# # # # ##### ### ### # # ### ####### # ### ### # ##### # # ### ##### # # # # # #
# #   # #       #   # # # #     # # # # #     #   # # # # # #       # #   #   # #
# ### # # # ##### ####### ### ### # ### ### # # ### # # ########### ####### #####
# #     # #   # # # #   #     # # #     # # # #   #         # # # #     #     # #
# ####### ##### # # # ### ### # # # ##### ### ### ##### # # # # # # # ####### # #
#           #           #   #     # #         #     #   # #       # # #         #
######################### #######################################################

