################### #############################################################
# # #           # #           # # #     # #   #   #       # # #       # # # #   #
# # ### ##### ### # ##### ### # # ### ### ### ### # ##### # # # ##### # # # ### #
# #       #     #     #   #     #             #     #               #     #     #
# ####### # ####### ##### # ############# ### # ### # ######### ######### ### # #
#   #     #       #     # #       #   #     #     # # #     #   # #       #   # #
# ### # ### ### # # ####### ### ### ### # # # ### ### # ### # ### # ##### # # # #
# # # # # #   # #     #       #     #   # # #   #   # # #   #   #   #     # # # #
# # # ### ########### ####### # ### ####### ##### ### # ### ######### ##### # # #
#   #           # # # #     # #   # # # #     # #   # # #       # #     #   # # #
# ##### ######### # ### ### # ### ### # # ### # ### ### ##### ### ##### ##### # #
#   #   #     #   #   # #   # # #   #       # # # # #     #   # #   # # #     # #
# ####### ####### # ##### ### # ############# # # ##### ### # # ### # ### ##### #
# #       #       # # #     #   #   # #         #     # # # #   # # #   # #   # #
# # # ##### # ##### # # # # # ### # # ### ### ### ### ### # ##### # # # ### ### #
#   # #   # # # #       # #     # #       #   #     #     #       # # #     #   #
# ### # ### ### # # # # ### ######### # ##### # # # ### ### ####### # ### # ### #
#   #       #   # # # # # # # # # #   #   #     # # # # #         # #   # #     #
### ### ####### # ### ### # # # # # ### ##### ####### ### # ### # # ### ##### ###
#     #         # #   # #   #       #     #       #   #   # # # #     #   # # # #
####### ### # # # # ### ################### ### ### ##### ### ####### # # # ### #
#       #   # #   #   #   #   # #           #   #       # #     # #     #       #
### ### # # ##### ### ### ### # ### ### ### ### ### ##### ### # # ### ######### #
# # #   # #     # # #           # # #     #   # #             # #         # #   #
# ### ##### ### # # ### ######### # # ######### ####### # ##### # ##### # # ### #
#   #   #   #   #     # # # #   #   # # #       # # #   #   # # # # #   #     # #
# ### ####### # ##### ### # # ##### ### ######### # ##### # # ##### ##### ##### #
# #   #       #   #   #   #               #           #   #   # # #   # # #     #
# ########### ####### ### ### # # ####### ##### ### # # # # # # # # ### ### # # #
# #     # #         #   #     # # # # #   #   # #   # # # # # # # #   #   # # # #
# # ### # # ####### # ### # ##### # # ### ### ##### # ##### ### # ### # ### #####
#     # # # #   # # #   # # # # # #       #       # #       # # #         #     #
# ### ### # # ### ####### ### # ##### ####### ##### ##### ### # ### ##### # ### #
#   # #     # # # # #   #       #     # #               #     #       # # #   # #
# # ####### # # # # # ####### ####### # ##### # ### ######### ### ##### # ### ###
# # #     #     #   #     #         #   # # # # # #   #   # #   # #   # # #     #
# ####### ### # ### # # ##### ##### ### # # ##### ### # ### # # ### ### # ### ###
#     #     # #     # # #   #     #   # #             #   #   #   # # #   #   # #
### ####### # # # ### # # ### ######### # ### ##### ### ### # ### # # # ##### # #
#   #     # # # #     # #     #       #     # # #   #   # # # # #           # # #
# ### ### # ### ####### # ### # # ### # # # ### ##### ### # ### # # ### ### ### #
#       #   #     #     #   # # # # #   # # # # #   #     #   #   # #   # #     #
##### ### # ##### ####### # ##### # # # # # # # # ### ########### ####### ##### #
#     #   #   #           # #   #   # # # # #       # # #           #       # # #
# ######### ### ##### ######### # ########### ##### # # # ####### # ### ### # # #
#     #     #     #       #     #         # # #     #   # #   # # # #   # #     #
### ##### # # # # ##### ##### # # ####### # # # ##### # # # # # ### ##### # ### #
#       # # # # # #   # #     # # # # #   #   #       #   # #     # #     # #   #
# # ############### ### # ##### # # # ### ####### ######### ### ##### ##### ### #
# # #           # #     #     #         #   #     #   #   #   #   #     #   #   #
# # # ########### ######### ####### # ### ### ### # ##### # ##### ### # ### #####
# #     #     # #       #         # # # #   #   #     #     #   # #   #     #   #
### ### # # ### ####### # # ####### ### ############# # # # # ######### # ### # #
#   #   # #       #       #   # #     #       #     #   # #   #   #     # #   # #
# # ### # ### ### # # ##### ### # ### # # # ### ### ### ### ### ### ### # # ### #
# #   #   #   #     #     #     #   #   # #     #   #     #   #     #   #     # #
################################### #############################################

