####################################### #########################################
# #       # # #       #             # #         # #           #   # #   #   #   #
# # # # # # # # ### ### # # ### ### # ##### ### # ### ##### ##### # ### # # # # #
#   # # #   #   # # #   # #   #   #   #   # #       # #       # # #   #   #   # #
# # ### # ### ### # ### # # ########### ##### ### ##### ### ### # # ### ### # ###
# #   # # #   # #       # # #     #       # #   #     #   #         # # #   # # #
##### # # # ### ### ####### # # # # ##### # ### ##### ##### ##### # # ### ### # #
# # # # #   # #     #   #     # # # #         #   #   #     #   # #   #   # #   #
# # # ####### # ### ### ##### ### # ######### # ####### ##### ##### # ### # # # #
#   #     # #     # #   #   # # # #         #       # #           # # #   #   # #
# # ### # # ##### # ### ### ### # # # ##### # ####### ### # ####### # ##### #####
# #   # #     #   # # # #   #       # #     #             #     #   # #   # #   #
# # # ### ### ##### # # # ### # ############### ##### # ##### ### # # # # # # ###
# # # #     #   # # #     #   #   # # #       #   # # # #   # #   # #   # #     #
# # ##### # ##### ####### # # # ### # ##### ### # # ####### ######### ####### ###
# #       # #     # # #   # # #             #   # #         # #   #     # #     #
# ##### ####### ### # # ### ########### ### # # ######### ### ### ### ### ##### #
# #       #   #   #     # # # # #   # #   # # # #   # #     #   #     #     # # #
# ##### ### ### # # # # # # # # # # # # ######### # # # ##### # # # # ### # # # #
# # # # #     # #   # #   # # # # # #           # # #       # #   # #     # #   #
# # # # ##### ### ##### ##### # ### # # ####### ### ### # # ### ####### ##### # #
#   #   #       # #       #       #   # # # # #   #     # # #   #   # #     # # #
##### # ### ### # # ### ####### # ####### # # # # ##### ######### ### # ####### #
# #   # # # #   # # # #   #   # # #     #       # #     #   # #     #   #       #
# # ##### ### # ### # # # # # # ### ### ##### ### ##### ### # ##### ### # #######
#   #       # # # #   # #   # # #   #   #   # #     #   #   # # #   # # # # #   #
### # ### # # ### # ### ##### # ### ### ### # # # ### ##### # # # ### ### # ### #
#     # # # #     #   #   #     #   # # # # # # #   #   #     #     #   #   #   #
####### # ##### # # # ##### ##### # # # # # # # # ### ### ### ### ##### # # # ###
#   #   #     # # # # #       #   #   #       # #   # #     #   #   #     # # # #
### ### ####### ##### ##### # # ######### ### ### ### ### ### ##### ####### # # #
#   # #   #   #     # #     # #         # # # #   #   #   #           #       # #
### # ### ### # ### # # ### # # # ######### ### ##### ### # ####### ### ### # # #
#     # #         #   # #   # # #   #       #       # #   # #         # # # #   #
# ### # # ##### ####### ##### ####### # ####### ### # ##### ### ##### # # ##### #
# # # #   #       #     #           # #   #     # # #       #     # #   # #     #
# # # ### ### ### ##### ### ### ### ### # # ##### # # # ### # # # # # ### ### # #
# #       #   # #     # #   #     #   # # #   # #   # # # # # # #   #   #     # #
# ### # # # # # ##### ######### ### ### # ### # # ##### # ##### ### # ### #######
#   # # # # #   # #   #     # # #     # # # # # #           #     # #   # # #   #
############### # ### # ##### # ####### ### # # # # # ### # # # # # # # # # ### #
#       #   #   #       #         #   #         # # # # # # # # # # # # #       #
# ####### ##### ### ##### ######### # ### ### ### ##### ##### ### # ### ####### #
# #       #     # # # #   # #   # # #       # #     #       # # # #   #   #   # #
# # # ########### # # ### # ### # # # ######### # ##### ####### ### ### ##### # #
# # #   # #       #   # #         # #       # # #   #     #   #   # # #   #   # #
# ##### # # ##### # # # ##### ########### ### ### # # ### # # ### # # ### # ### #
# #   #   #     #   # #   #   #           #       #   # # # #   # #     # #   # #
# # # # # ############# ##### # ############### ##### # ### ##### # ### # # # # #
# # #   # # # # # #     #   #   #           # # #   #   #   #   # #   # # # # # #
# # ####### # # # ### ### ##### ### # ####### ### # # ### # # # # ####### # # ###
# #           # #   #     # #       # #     #     # #   # #   #           # # # #
# # ### ####### ### # ### # ### # ##### ### # # ##### ### # # ### # ### # # ### #
#   #   #           #   # #     #     #   # # # # #     # # # # # #   # #   #   #
# ### # # ### ####### # # ### ####### # ### ### # # ######### # # ### ### # ### #
# #   #     #         # #       #     #   #               #   #     # #   #     #
########################################################################### #####

