############################################################################# ###
#     # #       #     #     #   #         #   # # #   #   #     #   #   #   #   #
### # # ##### ##### # ### ### ### # ### ### ### # # # ### ### # # # # # ### # # #
#   # #         #   # #   # #   # # # #     # #   # #         # # #   # #   # # #
##### # # ### # # ##### # # # # ### # ### ### ### # # # # ######### ### ### # # #
# # #   #   # # #       # #   # #     #         # # # # #   # #   # # #   #   # #
# # # ### ### # ##### ####### ### ### # ### ### # # # ### # # ### # # # ##### ###
# # # #   #   #     # # #         # # # #     #   # # # # #   #   #   #   # #   #
# # ######### ####### # # # # ##### # ##### ### ### # # # # ### ### # ### # ### #
#     #     # # #         # # #     # #       # # # #   # #     #   # #   # #   #
# ##### # # # # # ######### ##### # ######### # # ### ### ##### # # ### ### # # #
#     # # # #     # # # #   #     # # #       #   #   #     #     # #   # # # # #
# # ### # ####### # # # # ####### ### ######### # ### ########### # ### # # # # #
# # # # # #     #   # # #   #           #   # # # #       #       # #         # #
### # # ### ### ### # # ########### # # # ### ### ######### ### ##### # ##### # #
#           # #   # #     #       # # # # # # # # # #       #       # #     # # #
### # ### ### ### # # ### ##### ####### # # # # # # ### ####### # # ####### ### #
#   #   #     #   #   #       #         #       #       #       # # # #     # # #
# ### # # # ############# ##### ### ### ##### ### # # ####### # ### # ####### # #
#   # # # #       # # #   #   # # # # #   #   #   # # # #     #   #   # #       #
# ####### ######### # # # ### ### ### # ##### ######### # ### # ##### # # # # # #
#       # # # #     # # #         #   #     #           #   # #   # #   # # # # #
##### # ### # ### ### # ######### # ####### # # ##### # # # # ### # ### # ### # #
# # # # # #     #   #     #       #   # # #   # # #   #   # #   # # #   # #   # #
# # # # # ### # # ### ############# ### # ####### ##### # # ### # # ##### ### # #
#     #       # #   #             # # #   #         #   # #   # # # # # #   # # #
##### ### ### ### ### ### ### ##### # # ####### # # ### ### # ##### # # # ##### #
# #   #     #     #     # # # #     #       #   # # #     # #     #   # # # #   #
# # ######### # ########### # ##### ##### # ##### # # # ######### ### # ### ### #
# # #         # #         #     #   #   # # #     #   #   #       # #       # # #
# # # ######### # ##### # ### ##### # ##### ####### # ### # ####### # ####### # #
# # #   #   # # # #   # # #     # #   #       #   # # # # #     #   #   #   #   #
# # ####### # # # # ##### ### ### # ### ######### # # # # # ### # ### # # # ### #
#       #     #   #   # #   # #   #   #   #     # # #   # # # # # #   #   # #   #
# ######### ### # ### # ### # # # ### # ### ### # ####### ### # # ##### # # #####
#         # # # # #     # # # # #       # # # #   # #   #     #   #     # #   # #
### ##### # # ### # ##### # # ### # # # # ### # # # ### # # ######### # ### ### #
#   #   # # #       #       #     # # #   #     # #   # # #           # # #   # #
### # ### # ############### # ########### # # ### # ### ####### ### ### # ##### #
#   #   #   #       # #       #       #     # #   # #         # #     # # # # # #
##### ##### # ### ### ##### # # ########### ### # # ### ##### ### ####### # # # #
# #     # # # # #     # #   #   #       #   #   #   #     # # #             #   #
# # ### # ### # ####### ####### ### ### ########### ##### # # ####### ##### # # #
#     #   #     #   # #     #     #   # # # #       #   #   # #       #   #   # #
######### # ####### # ##### # ##### # ### # ### ### # # ##### # ####### ##### ###
#                     #     #       # #   #     #   # # #   # # #   # # # # #   #
##### ########### # # # # ### ####### ### # ##### ##### # ### # # ### # # # ### #
#             #   # #   #     #     #   #       #     # #             #   #   # #
# ### ### ### ####### # ##### # ### ######### # ##### # # ### ### ### # # ### # #
#   # #     # #       #     #   #   #         # #     #   #   #   #   # # #     #
# ### ####### ######### ##### ##### ### ### ### ##### # ### ########### ##### ###
#   #   # #         #   #   # #   # # # # #   #     # # #       # #       #   # #
# ### # # ##### ### ### # # ### ##### ### ##### ### ### ### ##### ####### # # # #
#   # # #     #   # #     #     #   #       #   # #   # # # # # #   # #     # # #
##### # # ### ########### ### ### ####### ### # # ### ### # # # # # # # ### # # #
#     # # #                 #         #       #   #       #   #   #       # #   #
######################################### #######################################

