################# ###############################################################
#     # #   # #           # #     # #             #       # #     # # #         #
# ### # # ### # ### ####### ### ### ### ##### ### ##### ### # ##### # ### # # ###
# #   #   #     #     # #       #   # # #   # #     #     #   # #       # # #   #
# # ### ####### ####### ##### ### ### ### ##### # ##### ##### # # ##### ####### #
# #         #       #   # #   #   #   #   #   # #   #   # # #     #   # # #     #
# ####### ##### # # ### # ### # ### # ### ### ### # ### # # ####### # # # ### ###
#   #     #   # # # #   #         # #     # # #   #     # #   # #   #   # #     #
### ### # # # ### # # ########### # ### ### # # ### ##### # ### ### # ### # # # #
# # # # # # # # # # #   #         #   #   #   #   # #       # # # # # # # # # # #
# # # # ### ### ### ### ### ####### ####### # ##### ##### # # # # # ### # # ### #
#   #                     # # #   #       # #   # # #     #       #     #   # # #
# ####### # # ####### ##### # # ##### ### # ##### # # # # # ### # ### # # ### ###
# #     # # # #       #   #         #   #   #     #   # # # #   #     #         #
# ##### # ####### ### # # ####### ### ##### ### ######### # ##### ### ### ##### #
# # #   # # # # # # #   #         #     # # #     #   #   #   # # #     # #   # #
### ### # # # # # # ### ### ### ### ##### ### ### # # # ### ### ####### # ### # #
# #     # # #     # #   #   #   #             # # # # # # #       #     #     # #
# # ##### # ####### ####### ##### ##### # ##### # # # # # # ########### ### #####
# # #     #   #                   #     # #     #   # #   # # #     #   #   #   #
# # ####### ### ### ### ##### ### ##### ####### ### ### # # # ##### ##### ### ###
#         #     #     # #   # # # #     # #     # #   # # #         #           #
# ### ### ### ### ### # # ##### ######### # # ### # ##### ### ######### ####### #
# #     # #   # # #   #   #   #   #       # # # #     #   # # #   #   # #     # #
# ### # # # ### # # ### # # # # ### # ### # ### # ### ### # ##### # # ### # #####
#   # # #     #   # # # # # #   #   # #   # #   # #   #       # #   # # # # # # #
# ### ### ##### # ### ### ### # # # ####### # ### ### ####### # # ### # # # # # #
#   # # #   # # #     # #   # # # # #       #   #   #   #       #   #     #   # #
# ##### ### # # # # ### ### ### ### ####### # ####### # ### ####### ####### ### #
#   # # #     # # #   #           # # # # #   # # #   # #       # # #     #   # #
# ### # ####### ##### ##### # ##### # # # ### # # ### # ##### ### # # ##### # # #
# #       #         #   # # # # # #         # #       #     # # #   #   #   #   #
# ##### ### ############# ### # # # ##### ### ##### # ### ### # ### ### #########
#     #         #         #   #       #   #     # # # #   # #             # #   #
# # ####### ##### # ######### ### ####### ##### # ##### ### ########### # # ### #
# #     # # #     # # #     #       # #   #     # # #     #           # #       #
##### ### # # ### ### ##### ######### # ####### # # # # # ### # ######### # # ###
# #   # #     #       #         #         #       #   # #     #     #     # # # #
# ##### ##### ##### # # # ### # # ### ### # ####### # ####### ####### # ####### #
#   # # #     # # # # # #   # # # #   # # #       # #     #       #   #   # #   #
### # # ### # # # # ### ##### ### # ### # ### ### ### ######### # ####### # # ###
# #         #     # #   # #   # # #   #   #   #     # #   #     # #   #         #
# # ### ################# # # # ####### ########### ### # # # ### # ##### # # ###
# # # #               #   # #   #   #     #   # # #     # # # #   #       # #   #
# ### # # # ### # ##### ### ### ### # # ##### # # ### ### # ##### ### # ### ### #
#     # # # #   # # # # #   # #     # # #         # #   #     # #     #   # #   #
### ### ##### ### # # # ### # ##### # ##### ####### ### ### # # # ##### # ### ###
#   #     #   #   #           #   #   #   #     # # #     # #   # #   # # # # # #
# # # ### ##### ##### ##### ##### # ##### ### ### # ##### ##### ##### ##### # # #
# #   #   #         # #   #   #         #           # #     # #       # #   #   #
### # # ### ##### # # # # # ########### # ### # ##### # ### # ######### ### ### #
#   # #   #     # # # # # # #         #   #   #   # # # #   #         #       # #
# ### ######### ##### ### # ##### # # # # # ##### # # # ##### # ### ### ### #####
# #   #   # #       #   #         # # # # # #         #   #   # #         #     #
# ### # # # ### # # ##### ########### ### # # # # ### ### ### ######### ### #####
# #     # #     # # #           #       # # # # # #   #               # #       #
######################################################### #######################

