########################################################### #####################
# #     # # #     # #   # #   #             # #   #   # #     # #     #       # #
# # # ### # # ### # # ### # ### ######### ### # ### # # # ##### # # # ##### # # #
#   #   #     #             #       #   #     #   # # #   # #   # # # # # # #   #
### ### # ####### ##### ####### ### ### # ### # # # # ### # # ### ### # # # #####
#   #   # #     #   #   #   #   #     #   #   # #   # #         # # #   #       #
# # ##### # ### ####### ### # ####### # # ### ### # ### # # ### ### ### # ### ###
# #     # # #   #       # #       #   # # #     # #   # # # #   # #         #   #
# ##### # # # # ### ### # # ######### ### # ### ### ### ##### ### # ######### ###
# #   #   # # # #   # #   # #         # # #   #         # #     #     #   # #   #
##### ### ### ####### ### # ##### ##### ##### ####### ### ########### # # # # # #
#     # # #       #             # # # # # # #     #       #       # #   #   # # #
# ##### # ### ### ##### ##### # # # # # # # ####### # # ##### # ### # # # # #####
# #       #     #       #   # # #   #         #     # #     # #       # # #     #
# ### ####### ### # ##### ### ####### # ##### ############# # ####### ####### # #
# #   # #     #   # #     #     #   # # #     #   # #       # #     #       # # #
# ### # ############# ### # ### ### ### ####### ### ####### # # ### # ### #######
# # #   #           # #   #   # #         #     # #       #   #   # #   #   #   #
# # # ##### ##### # ### ### ######### ### # ### # ##### ####### ### # ##### # ###
#   #       #     # #   # # #     #     #   # # #     # #     # # # # # #       #
# # # # ####### ### # ### # ### # ##### ##### # ##### # ### ### # ### # ### ### #
# # # # # # #   #   # # #     # #   #       # #   #   # #   #       #     # # # #
# # # ### # ### ##### # ####### # # # ### ### ##### ### ### ### ##### ##### # ###
# # #     #               #     # #   # #   # #   #   #     #     #   #         #
# ########### # ##### ####### # ##### # # ### # ### # ### ### # ##### # #########
# # #         #   # # # # #   #   #   # #     # #   # # # #   # # #   #         #
# # # ####### ### # # # # # # ####### # ### ### # # # # # ##### # # # ####### # #
#   # #   #     # # #       #       #   # # #   # # #   #       #   #       # # #
### # ### ### ### # ### ##### ### ##### # ### ### ####### ######### ### ##### # #
#     #       #     # #     #   # # #         # #           #   #   #       # # #
### # # ##### ### ### ### ####### # ##### ### # ##### # ### ### # ##### ####### #
# # # #   #   #     # #   #       #     # #   #   #   #   #     # #     #       #
# # ### ############# ##### ######### ##### ##### ####### ### ### ######### #####
# # #   #   #     #         #       #         #     #   # #     # # #     # #   #
# # ### # # ##### # ######### # ### # # ### ####### # ##### ### # # # # # # # ###
#     #   # #             # # # # # # # #   #       #   #   # # # # # # # #     #
##### ######### # # ### ### # ### ### # ##### ######### # ### ##### ### ####### #
#   #   # #     # # #   # # #     #   #         #     # # #   #     # #       # #
# ##### # ########### ### # ### # ### # ##### ### ##### # # ### ##### # # # # # #
#   # #   #         #     #   # #     #     #                 # #     # # # #   #
### # ##### ############# # ##### ####### ### ##### # ######### ### ##### # ### #
# #       #             #     # #   #   # #     # # #       # #         # #   # #
# # # # # # ##### ######### # # # # ### ### ##### # ####### # ##### ### ### # ###
# # # # # #   #           # #   # # #     # # # #     #   # # #       # # # #   #
# ### ####### ##### # ### # # ##### # # ##### # # ####### ### ### ##### # ### ###
#         #       # # #     #     #   # #     # #   #   #   # #     #       #   #
# # ### ##### ##### ##### ##### ##### # ##### # ### # ### ### # ############### #
# # #   #     #     #   # #   #     # #   #   # #   #                 #     #   #
# ### ### ##### ##### ### ### ### ### ##### ### # # ####### ### ####### ##### ###
#   # # #     #       #     # #   #   #     #   # #   # #   # # #               #
### ### # ### ### ##### ##### ####### # ### # # ##### # ### # # # ### ### # # # #
#         #   # #   #             # #     #   # #   #   #   #     # # #   # # # #
# ### # ####### # ### ### # # # ### # ####### ##### ### ##### ### # ##### ##### #
#   # #       #     # #   # # #     #   #           #     #     #   #     #     #
######################### #######################################################

