########################### #####################################################
#   # #                 #   #   #         # #     # #   #           #           #
# # # # ### ######### # # ### # # ##### # # # ### # # # # ####### ### ######### #
# # #   #   #     #   # #     #   #   # #   # # #   # # # #     # #   #     # # #
# ### ### ### ### # ### ### # ##### # ####### # ### # # ### # # # # ### # # # # #
# #   # # #     #   # #   # #     # #         # #   # # #   # #   # #   # # #   #
# # # # # # ##### ### ### # ##### # ########### # ### # # ######### # ### # #####
#   # # # # #     #   #   # #       # #     #   # #   # #       #   # #   # #   #
# ### # # # # ##### # ### # ######### # ### # ### # # ### ##### # # # ##### # # #
# # #   # # #   #   #   # # #         # #   # #     #     #       #   #   #   # #
# # ### # ##### # ##### # # # ######### ### # ######################### # # ### #
#   #   #     #   #   # # # # #     #   #   #       #   #     #   #   # # # #   #
##### ####### ### # ### # # # # ### # ### ####### # ### # ### # ### # ### # # ###
# #   #   #     # # #   # #   #   #   #   # #   # # #   # # #     # #     # #   #
# # ### # # ### # # # ### ####### ### ##### # # # # # # # # ##### # ####### ### #
#     # #   #   # #   # # #   #     #   #     # # #   #   #       #   # #   #   #
# ##### ##### ### ##### # # # # ####### # ##### # ############# ##### # # # ### #
# #     #       #       #   # #   #     #   #   # #       #     #     # # # # # #
### ############### ############# # ##### # # ### ### ### # # ##### ### # ### # #
#   #   #         #     #         #       # # # #   # #   # #   #   #   #   # # #
# # ### # ####### ##### # ################# # # # # # # ### ##### ### # ### # # #
# #   #   #     #   #   # #       #   # #   #   # # # # #         #   #   # # # #
# ### ####### # ### # # # # ##### # # # # ####### # ### # ######### ##### # # # #
# #   #       # #     # #   #   # # # #   #   # # # #   #   #   #   #   # #   # #
# # # ### ##### ############# # # # # # ### # # # # # ### # # # # ##### # ##### #
# # #     #   #   #     # #   #   # # #     #   # # # #   # # #     #   #   #   #
### ####### ### # # ### # # ##### ### ####### ### # # # ##### ##### # ####### ###
#   #     #     # #   #   #     #   #       #     #   # #       #   #         # #
# ####### ####### # # ######### ### ####### ########### # ### # ########### ### #
#       #         # #     #   #   # #     #   #   #     #   # #         #   #   #
##### # ########### ### # ### ### # # ### ### ### # ####### # ######### # # ### #
#     #   #       #   # #       # # # # #   #     #       # #   #     #   #     #
##### ### # ##### # # ######### # # # # ### ##### ####### # ### # ###############
#   # #   # #   #   #     #   #   # # #   #     #   # #   # #   #   #           #
# # # # ### # ########### # # ##### # ### ### # ### # # # # ####### # ######### #
# # # #   #     #         # #       #       # #     #   #   #       # #         #
# # ##### ##### # ######### ################# ############### ##### ### ### #####
# # #     #     #   #     #     #         #   #   #           #   #   #   # #   #
### # # ########### # ### ### # ######### # ### # # ########### ### # ### # ### #
#     # #   #     # # #   #   #     #   #   #   # #     #   #   #   #     #     #
# ####### # # ### # # # # # ####### # # # ##### ####### # # # ### ##### #########
# #       #   # # #   # # #       #   # # #   # #   #     #   #   #     #       #
# # ##### ##### # ##### ### ##### ##### # # # # # # # ########### ####### ##### #
# #     #       #   #   #   # #   #   #   # #   # # # # #   #     #   #   #     #
# ##### ######### ### ### ### # ### # ##### ### # # # # # # # ##### # # ### #####
# #         #   #   # # # #   #   # #   # #   #   #   #   #   # #   #   #   #   #
# # ####### # # ### # # # # # ### # ### # # # ############### # # ##### # ### # #
# # #       # #   #   #     # #     # #   # #   #           #   # #     # #   # #
# # # ### ####### ############# ##### ########### ### ##### ### ### # ### ##### #
#   # #   #   #       #       # #       #     #   # #     #   #     # # #     # #
##### # ### # ####### ####### # # ##### # ### # ### ### # ##### ##### # ##### # #
#     #     #       #   #   # # #     # #   #   # #   # #     #   #   # #   #   #
# ################# ### # # # # ##### # ### ##### # # # ##### # # # ### # # #####
# #   #     #     #     # # #   #     #     #   #   #   #     # # #   # # #     #
# # # # ### # ### ##### ### ##### ########### # ######### ####### # ### # ##### #
#   #   #     #       #           #           #                   #       #     #
####################### #########################################################

