######################################################################### #######
#     #     #     #         # #   #   #     #         #   #   #   #             #
# ### ### # # # # ##### ### # # # # # ### # # ####### # # # ### # # ####### #####
#   #   # #   # #     #   #   # # # #     # #   #   #   # #     # # #     #     #
### # # ### ######### ### ### # # ##### ### ### ### ##### # ####### # # ### ### #
# # # #   #     #     #     #   #   #   #   #   #       # # #       # #     #   #
# # # ### ##### # ############### # # ### ### # # ####### # # # ##### ##### # ###
# # # #   #     #   #   #       # # #   # #   # #       # #   # #     #   # # # #
# # # # ####### ### # # ####### # ### # ### # ######### # # ##### # ##### # # # #
#   # #   #   # #   # # #     #       #     #   #       # # #     # #   # # #   #
### # ### # # ### # # # ### ################### # ####### ### ##### # # # # #####
# # #   #   #   # # # #   #   #   #             #       #   # #   #   #   # #   #
# # ### ####### # ### # # ### # # ############### ##### ### # # ######### # # # #
#     #       # #     # #   #   #         #       #     # #   #     #     #   # #
############# # ####### ### ### ######### # ######### ### ##### # # ######### # #
#   #         #   #   #   # #   #           #     #   #     #   # #           # #
# # # ########### # ### # # ##### ### ########### # ### ### # ###################
# # #   #     #   #     # #     #   # #   #       # #   # # #   #       #       #
# # ### ### # # ######### ##### ### ### # # ##### # # ### # ### # ##### # ##### #
# #   # #   # # #   #     #   # # #   # # #   #   #   #     #   # #   #   #     #
# ### # # ### # # # # ##### # # # # # ### ### # ### ### ##### ### # # ##### # ###
#   #   # #   # # # #   #   # #   # #   #     # #   #   # #   #     # # #   # # #
### ##### # # # # # ### # ### ####### # ####### # ### ### # # ####### # # ### # #
#   #     # # #   # #   #   #       # #         #   # #   # #         #   #   # #
# ##### ### ####### # ##### # ##### # ############# # # ### ############### ### #
#     #   #     # # #       #   #     #     #   #   #   #   #       #     # #   #
##### ### ##### # # # ######### ########### # ### # ##### ### ##### ##### # # ###
# #   #   #   #   # #   #   #       #     # #   # #   #       #   # #     # #   #
# # # # ### ####### ### ### # ##### # ### # ### # ##### ####### # # # ### # ### #
#   # #   #       #     #   #   # #   #   #     #       #       #   # #   #   # #
# ### ### ####### ####### ##### # ##### ### ################### ##### # ##### # #
# # #     #     #     #   #   #   #       # #     # #   #     #       # #   #   #
# # # ######### # ### # ### # ### ####### # ### # # # # # # # ########### # #####
# # #           #   # #   # #     #   #   # #   # #   #   # # #         # #     #
# # ############### # ### # # ##### # # ### # ### ##### ##### # ####### # #######
#   #           #   #   # # # #     # #     #   #   #   #     #   #   # #       #
### ########### # ##### # # # # ##### ######### ### # ### ####### # # ### ### # #
#   #   #   #     # #     # # #   # # #       #   #   # #       #   #   #   # # #
##### # # # # ##### # ##### # ### # # # ##### # # ### # ####### ####### # # ### #
#   # #   # #       # #   # # # #   #   #   #   #   #   #     #         # # #   #
# # # ##### ######### # # # # # # ####### # ### ############# # ####### ### # ###
# #   #   #   #         # # # #   #       #   # #   #     #   #       #     # # #
# ##### # ### # ########### # # ### ######### ### # # ### # ######### ####### # #
#   #   #     #   #   #     # #   # # #     #     #   #     #       # #   #     #
### # ##### ##### # # # ######### # # # ### ### ############# ##### # ### # #####
#   #     #     #   #   #         # # # # #   #     #       #   #   # #   # #   #
# ############# ### ############### # # # # # ##### # ##### ### # ### # ### # # #
# #           #     #     #   #     # #   # #   #   #     #     # # #   # #   # #
# # # ####### ######### # ### # ##### ######### # ####### ### ### # # ### # ### #
# # #   #   #     #     #   #   #   #         # #   #   #   #   # # #     #   # #
# # # # # # ##### ### ##### ##### # # ####### # ### # # ### ### # # ########### #
# # # #   # #   # #   #   #       # # #       #     # # #   # # #   #         # #
# # ####### # ### # ### # # ######### ##### # # ##### # # # # # ### # ####### # #
#   #     # #     #     # #         #     # #   #     #   # # # #   #     # #   #
##### ##### # ########### ######### ##### # ##### ######### # # # ####### # # ###
#           #             #               #       #         #   #         #     #
############################# ###################################################

