############################################################################### #
#     #               # #           #           #   #         # #     #   # #   #
# ##### ############# # # ####### # ### # ##### ### # # # ### # # ### # # # # # #
# #     #       # #   #   #     # #     #   #       # # #   # #   #   # #   # # #
# # ##### ##### # # ### ### ### ##### ####### ####### ##### # ### ##### # # # # #
# #   #   #   #   # # #   #   #     # #     # #     #     # #   #       # # # # #
# ### # ### ### ### # # # ### ##### # # ### # # ### ##### # ### ######### ### # #
#   #   #   #   # # # # # #   #     #   #   #   #       # # # #   # #   #   # # #
# ######### # ### # # # # # # # # ############### ##### ### # # # # # # # # # # #
# #   #   # #   #   #   # # # # #           #     #       # # # #   # # # #   # #
# # # # # # # # ### ##### # ### ########### # ########### # # # ### # # ##### # #
# # # # #   # #   #   #   #   #         #   #     #   #   # #   # #   #     # # #
# # # # ######### ### # ##### # ######### ### ##### # # ### # ### # ####### # ###
#   # # #         #     #     # #     #   #   #   # # #   # # #   # #       #   #
# ##### # ############### ##### # ### # ### ### # # # ### # ### ### # ######### #
#   #   #     #       #   # #   # # #   #   # # #   # # # #   # #   #     #     #
### # ##### # ### ### # ### # ### # ### # ### # ##### # # # # # # ####### # ### #
#   # #     # #   # #     #   #   #     #   #   # #   #   # # # #     #     #   #
# # # ####### # ### ##### ##### ### ####### ### # # ####### # # ####### ##### ###
# #           #   #   #   #   #   #       # #   # # #   #   # #   #     #   #   #
# ############### ### # ### # ### ####### # # ### # # # # ##### # # ##### # #####
#   #   #     #   #   #   # #   #       # #   #   #   #   #     # #     # #     #
# # # # # ### ### # ##### # ### ####### ####### # ######### ### ####### ### ### #
# #   # # # #   #   #     #   #         #     # #   #   #   # # #   #   #   #   #
##### # # # ### ##### ############# ##### ### # ##### # # # # # # # # # # ### ###
#     #   #     # #   #           # #     # # #   #   #   # # #   # # # # #   # #
# ############# # # ### ######### # # ### # # ### # ####### # ### # ### # # ### #
#   #           # #     #   #   # # #   #   #       #     # #     #   # # #     #
# # ### ####### # ####### # # # # # ####### ##### ####### ### ####### # # #######
# #   # #     # #         # # # # #       #     #       # #   #   #   #   #     #
##### ### ### # ########### # # # # ##### ########### # # # ##### # # ####### ###
#   #   # #   #             # #   # #   #   #   #   # #   #   #   # #   #   #   #
# # ### # # ################# ##### # ### ### # # # ######### # ### ### # # ### #
# # # #   # #               #   # # #   #     #   #   # #   #   # #   #   #     #
# # # ##### # ######### ### ### # # # # ############# # # # # ### ### # ### #####
# # # #   # #     #   # #   #   # # # #   #         # #   # # #       # # # #   #
# # # # # # # ### # # ### ### ### # # ### # ####### # ##### ### # ##### # # # # #
# #   # #   # #   # # #   # # #   # #   # #     # #   #     #   # #     #   # # #
# # # # ### ### ### # # # # ### # ##### # # ### # # ### ##### ##### ######### # #
# # # #   # #   # # #   #   #   #     # # #   #   #   #       #     #       # # #
### # # ### # # # # ######### ####### # # ########### # ####### ##### ##### # # #
#   # # #   # # #   #   #     #   #   # #             #     #     #   #   # # # #
# ### # # ### # ##### # # ### # # ##### ########### ####### ##### # ##### # # # #
# #   # #     # #   # #   # #   #   # #   #   #   # #     #     # #   #   #   # #
# # ####### # # # # # ##### ####### # # # ### # ### ### # # ### # ### # ####### #
# # #       # #   # # #   # #     # # # #     #   #     # #   # # #   # #     # #
# # # ####### ##### # # # # # ### # # # ####### # ####### ##### # # ### # ### # #
# # #     # #     #   # #     #   #     #       # #   # #     # # #     # #     #
# # ##### # # ##### ### ################### ##### # # # ##### # # ##### ### #####
# # #   #   # #   #   #   # #   #   #       #   #   # #     #   #     #   #   # #
# ### # # # # # # ##### # # # # # # # # ##### # ##### # ### ######### ### ### # #
# #   # # # # # #   #   # #   # # #   #   #   #   #   # # #   #       #   #   # #
# # ### # # ### ### # ##### ### ### ####### ### ### # # # ### # ####### ### ### #
# #   # # #   #   # #     #   #   # #       #   #   # # #     #         #       #
# ### # # ### ### # ##### ##### # # # ##### ##### # # # # #######################
#     #   #       #             #   #     #       # #   #                       #
####################################################### #########################

