######################### #######################################################
#   #           #     #     #       #   #   #       #   #             #     #   #
# # # ##### ##### ### ##### # # ### # ### # # ### # # # ### ######### ### # ### #
# #     #   #   # #       # # # #   #   # # #   # # # #     #       #     #   # #
# ####### ### # ### ##### # # # # ### # ### # # ### # ####### ##### ### # ### # #
# #     # #   # #   #   # # # # #     #     # #   # #     #   # #   #   #   # # #
### ### # # ### # ### # # # # ##### ######### ### ### ### # # # # ### ####### # #
#   # # #   #     #   #     # #   #   #   #   #   #   #     # #   # # #     #   #
# # # # ### ################# # # ### # # # ### ### ########### # # # # ### #####
# #   #   #   #     #       #   # # #   #     #   #           # #   #   # # #   #
######### ### # ### # ### # ### # # ############# ########### ##### ##### # # # #
#       #   # #   #   #   # #   #     #     #     #         #     #     #     # #
# # ### # # # ### ### ##### # ####### # ##### ### ######### ##### ##### ####### #
# # # #   # #   # #   #     # #   #     #     #       # #   #       # #       # #
# # # ####### # # ##### ### ### # ####### ########### # # ### ##### # ####### ###
# #     # #   #   #     # #     #     # #       #   # # #     #   # #       #   #
# # ### # # ####### ##### ####### ### # ##### # # # # # ####### ### # ######### #
# #   # #   #       #   #       #   #   #     # # # #   #   # #   # # #       # #
# ##### # ########### # # ##### ### ##### ##### # # ### # # # # # # # ### ### # #
#     # #           # #   #     # #     # #       # # #   #   # # # #     #   # #
##### ##### ####### # # ####### # ##### # ####### # # # ####### # # ####### ### #
#   #     #   #     # #       #   #     #       # # # #       # #   #     # #   #
# # ##### ##### # # ######### ##### ########### ### # # ##### # ##### ### # # ###
# # #   #       # #     # #     #       #   #   #   # #   #   # #   #   #   #   #
# # # ### ####### ##### # # ##### ##### ### # ### ### ##### ### # # # # ####### #
# # #   #   #     #   #   #     #   # #   #   #       #     # #   # # #         #
# ##### ### # ##### # # ####### ### # ### # ########### ##### # ### ### ####### #
#     # #   #   #   # # #     #     #   # #       #   #   # #   # #   # #     # #
# ### # ##### # # ### # # ### ####### ### ####### # # ### # # ### # # ### ### ###
# # # #       # #   #   # # #   #   #     #     #   #   #   #     # #     # #   #
# # # ########### # # # # # ### # # ### ##### ######### # ######### ####### # # #
#   # #     #   # # # # # #   #   #   #       #         #   #     #       # # # #
### # # ##### # # # # # # ### ####### ######### # ######### # ### ####### # # # #
# # # # #     #   # # #   # # #     #       #   # #   #   # #   # #       # # # #
# # # # # ####### # ####### # # ### # ##### # ##### # # ### ### ### ### ### # # #
#   # #   # #     #   #   # #     # #   #     #   # # #   #   #   #   # #     # #
# ### ### # # ####### # ### # ### ##### ####### # # ### # ### ### ### ### ##### #
#   # # #   # #   # # #     #   #     #         #     # #   #   #     #   #     #
### # # ### ### # # # # ######### # ################# ### # ### ####### ### #####
#   #     #   # #   # #         # # #       #   #     #   #   # #     #   #   # #
##### ####### # # ### ######### # # # ##### # # # ##### ##### ### # # ### ### # #
#   #     #   # # #   #   #     # #   #     # #   #   #   #     # # #   #   #   #
# # ##### # ### # # ### # # ####### ######### ### # ### # ##### # ### ##### ### #
# # #   #     # # # #   # #   #   #       #   #   #   # #     # # #   #   # #   #
# # # # ##### # # # ### # ### ### ##### # ##### ##### # ##### # # # ### # # # ###
# #   #       # # #     #   # #       # # #     #   #   #   # # # #     # # #   #
# ######### ### ########### # ####### # # # # ### # ##### ### # # ####### # ### #
#     #   #   # #     #   #   #       # #   # #   #       #   # # #   # #   # # #
### # # ##### # # # # # # ######### ######### # ########### ### # # # # ##### # #
#   #   #     #   # #   #     #     #     # # # #         #   #     # #     #   #
######### ##### ############# # ##### ### # # # # ####### ### ######### ##### # #
#       #   # # #           #       #   #   # #   #         # # #       #     # #
# ##### ### # # # # ################# ### # # ##### ####### # # # ####### ##### #
# #       #   #   #   #   #     #     #   # #       #   # #       #   # #     # #
# ########### ####### # # # ### # ### # ##### ####### # # ######### # # ##### # #
#             #         #   #     #   #       #       #             #         # #
############################################################# ###################

