############################# ###################################################
#             #       # #   #   #                         #   #     #       #   #
### ######### ##### # # # ### # ########### # ####### ### # # # ### ### ### # ###
#   #   #       #   #   # #   # #           # #   #   #   # # #   # #   #   #   #
# ### ### ##### # ##### # # # # # ########### ### # ### ### # ### # # ##### ### #
#   #     #   # # #   #   # # #   #   #   #       # #   #   # # # # #     # # # #
### ####### ### # # # ##### # ##### # # # ####### # # ### ### # # ### # # # # # #
# #       #   # #   #   #   #   #   #   #   #     # #     # #   #   # # # # # # #
# # ######### # # ##### ### ##### ### ##### # ############# # # ### # ### # # # #
# # # #       # #     #     #     # # #     #       #       # #   #   #   # # # #
# # # # ######### ### ####### ##### # # ########### # ##### # ##### ### ### # # #
# # # # #     #   # # # #     #   #   #   #       # #   #   #     #   # #   #   #
# # # # # # # # # # # # # ##### # # ##### # ##### ### # ##### ### ### # # ### ###
# #   #   # #   # # # #     # # # #     #   #   # #   #     #   #   # # #   #   #
# ### ######### ### # ##### # # # # ######### # # # ####### ##### # # # ##### # #
#   #     #   # #   #       #   #   #         #   # # #     #     # # # #     # #
# # ##### # # # # ################### ############# # # ##### ##### ### # # ### #
# #       # # # # #     # #   #       #       #   #   # #     #         # #   # #
# ######### # # # ##### # # # # ##### ####### # # ### # # ############### ##### #
#   #       # # #     #     #   #   # #     # # #   # # #         #     #   #   #
### # ####### # ##### ######### ### # # ### # # ### # # ######### # ### ### # ###
#   #   #     #   #   #       #   #   #   # #   #   # # #         #   #   # #   #
# ##### # ####### # ### ##### ### ### ### # ##### # ### # ######### # ### # ### #
#   #   # #   #   # #   #   # # #   # #   #       #   #   #         #   #   # # #
# # ### # # # # ### # ### # # # ### # # ############# ### # ############# ### # #
# #   # # # #   # #   #   # #     # # # #   #       #   # #   #     # #   #   # #
##### # # # # ### # # ##### ##### # ### # # ####### ### # ### ### # # # ##### # #
#     # #   #     # #     #       # #   # # #   #   # # #   #     # # #   #   # #
# ##### ########### ### # ######### # # ### # # # # # # ##### ##### # ### # ### #
# #     #     #     #   #       #   # #       # # #   #       #       #   #     #
# # ##### ### ##### ########### # ### ########### ### ################# #########
# #   # #   #     #     #     #   #   # #       # # #                 # #       #
# # # # ### ##### ##### # ####### ### # # ##### # # # ############### # ### ### #
# # #   # #     # #   #         #   #   #   # #     # #       #   #   #   # # # #
# # ### # ##### # # # ######### ### ####### # ####### ##### # ### # ### # # # # #
# # #   #       # # #     # #   #   #     # # #   #         #   # # #   #   #   #
# # # # ######### ### ### # # ### ### ### # # # # # ########### # # # ######### #
# # # #         #     # #   #   #   # #   #   # #   #     #     # # # # #       #
# ### ########### ### # ####### ### # # ####### ##### ### # ##### # # # # #######
#   #       #   #   # # #       #   # #         #   #   # #   #   #   #     #   #
### # ##### # # ### # # # ####### ####### ####### ### # ### # # ####### ### # ###
# # # #     # # #   #   # #   # #       # #     #     # #   #   # #     #   #   #
# # ### # # ### ##### # # # # # ####### # # ### ####### # ### ### # ##### ##### #
# # #   # #   #     # # # # #         #   #   # #     # # #   #   # #   # #     #
# # # ####### ##### ### # # ####### # ####### # ##### # # # ### ### # # # # #####
# # #       #   #   #   # #       # #         #   #     # # #   #   # # #   #   #
# # ##### # ### # ### ### ####### ######### ##### # ### # ### ### ### # ##### # #
#   #   # # #   # #     #   #   #   #     # #   # #   # # #   #   #   #     # # #
### # # ### # ### ##### # # # # ### # ### ### # ##### # # # ### ####### # ### # #
#   # # #   #     #   # # # # #     # #   #   # #     #   # #   #     # #     # #
# ### # # ######### # # ### # ####### # ### ### # ######### # ##### # ### ##### #
# #   # # #   # #   # #     # #       #       #   # #       # #     #   #     # #
# # ### # # # # # ### # ##### # ################### # ##### # # ##### # ##### # #
#   #   # # # # # #   # # #   #   #       #     #   #     # #   #   # #   #   # #
# # ##### # # # # # ### # # # ### ####### # ### ### ##### ### ### # ### # ### # #
# #       # #     #     #   #               #       #         #   #     #     # #
########################################################### #####################

