############### #################################################################
#       #         # #         #         #   #     #       #           #       # #
# ##### # ### ### # # ### ##### ##### ### # # ### # ##### # ### ### # ##### # # #
# #     # # #   #   #   # # #   #   # #   #   #     #     #   # #   # #     #   #
# # ##### # ### ####### # # # ### # # # # ################# # # ##### # #########
# #       # #   #     # #     # # #   # #   #           #   # # #   # #         #
# ######### # ### ### # ##### # # ##### ### # ######### # ### # # # # ######### #
#   #     #   # #   #   #     #       # #   # #       # # #   #   # #     #   # #
### # ### # ### # ##### ############# ### # ### ### ### # # ########### # # # # #
# #   # # # #   # #   #       #     #     # #   # # #   # # #       #   # # #   #
# ##### # # # # # # # ####### # ### ####### # ### # # # ### # ##### # ##### # ###
#   # # # #   #   # #       #   # #       #   # #   # #   #   #   # #       #   #
# # # # # ######### ####### ### # ####### ##### # # ##### ##### ### ########### #
# #   # #     #   # #   #     # # #       # #     #     # #   # #   #       #   #
# # # # ### # # # ### # ##### # # # ####### # ######### # # # # # # # ##### #####
# # #   #   # # #     #     # # #   #       #   #       # # # #   # #   #   #   #
# ####### ### # ########### # # ##### ##### ##### ####### # # # # ####### # # # #
# #     #   #   #     #   # # #   #     #   #     #     #   # # #     #   #   # #
# # ### ### ##### # # ### # # ### ##### # ### ####### # ### # ####### # ####### #
#   #   #   #     # #     #   # #   #   #     #     # #   # #   #   #   # #     #
##### # ### # ############### # ### # ######### ### # ### # ### # # # ### # # ###
#     #     #     #       # #   #   #   #     #   # # # # #   # # #     #   #   #
# ############### # ### # # # ##### ##### # # ### # # # # ### # # ##### #########
#           #     # # # # #   #   #   #   # #     # # # # #   # #     #   #     #
########### ##### # # # # ### # # ### # ### ####### # # # # ### ##### ### # ### #
# #         #   # #   # #   # # #   # #   #       # # # # #   #     #   #   #   #
# # ######### # # ######### # # ### # ### ####### # # # # ##### ### # # ### # ###
#   # #       # #   #       # # # # #     #   #   #   # #   #   #   # # # # #   #
# # # # ####### ### # ######### # # # ##### # ####### # ### # ### ### # # # #####
# # # #   #   #   # #   #     #   # # #     #   #     #       #   # # # # #     #
# # # ### # ##### # # # # ### ### # ### ####### # ### ########### # # # # ##### #
# #   #   # #   #   # # #   #   # #     #   #   #   # #     #     #   # #   #   #
# ##### ### # # ##### # ### ### # ####### # # ##### ### # ### ######### ### # ###
#     #     # # #     #   #   #   #       # # #   # #   # #   #       #   # #   #
##### ##### # # # ####### ### ##### ####### # # # # # ### # ### ##### ### # ### #
# #   #     # # # #     # #     #   #     # #   # # #   #   #   #     #   #     #
# # ### # ### # ### ### # # ##### ### ### # # ### # ### ####### # ######### #####
#   # # # #   #     # # #   #   #   #   # # #   #   # # #       #     #     #   #
### # # ### ####### # # ##### # ##### # # # ### ##### # # ### ####### # ##### # #
#   # #     #       #   #     #       # # #   # #     # # #   #     # #       # #
# ### ##### ############# ############### # # ### # ### # # ### ### ### ####### #
#   #   # #   # #         #     #         # #   # #   # # # #     #   # #       #
### # # # ### # # ####### # ##### ##### ##### # # ### # # # ####### # # # #######
# #   # #     # #   #   # #     # #   #       #   #   #   #     #   # # # #     #
# # ### # ##### ### # # # ##### # # # ##################### ### # ##### # # ### #
# # #   #   #       # #   #   #   # # #   #     #   #     # #     #     # # #   #
# ### ##### # ####### ##### ##### # ### # # ### # # # ### # ####### ### # # # ###
#     #       #   #   #             #   # #   # # # # #   #     #   #   #   #   #
####### # ##### ### ################# ### ### ### # # # ##### # # ############# #
#       # #   #   #   #   #         #   #   #     # # #       #   #   #       # #
# ######### # ### ### # # # ####### # ##### ####### # ############# # # ##### # #
#           #     # #   #   #     #   #         # #   #             # #   #   # #
# # ############### ######### ### ##### ####### # ##### ########### ##### ##### #
# # #       #         # #   #   # #   #       #   #     #         # #   #     # #
# ### ##### # ####### # # # ### # # # ####### ##### # ### ####### ### # ### # # #
#     #       #           #     #   #       #       #           #     #     #   #
####################################################################### #########

