##### ###########################################################################
# #       #       #     #       # #   #     #                         #   #     #
# # # ### # ####### # # # ##### # # # # # ### ################# ####### # # ### #
# # #   # #   #     # #   #   #     #   # #   #   #           #   #   # #   #   #
# # ### # ### # ##### ### # ############# # ### # # ######### ### # # # ##### ###
# #   # #   # #   # #   #   #             # #   # #     #   # #   # #   #     # #
# ### ### # # ### # # # ##### ############# # # # ### # ### # ##### ##### ##### #
# # # #   # #     #   # #   #         #     # # # #   #   #   #   # # #         #
# # # # # ### ########### # ### ##### # ### ### # # ##### ##### # # # # ####### #
# # # # # #   # #     #   # #   #   # #   #   # #       # #   # # # # # #       #
# # # # ### # # # ### # ### # ### # ##### ### # ######### # # # # # # # # #######
# #   #     # #   #   #   # # # # #   #     #   # #       # #   # # #   #   #   #
# # ######### ##### # ### # # # # ### # ##### ### # ### ### # ### ### ##### # # #
#   #       #     # #   # #   #   # #   # #   #   # #   #   # #       #   #   # #
# ######### ##### # ### # ##### ### ### # # ### ### # ### ### ######### # #######
#           # #   #   #   #   # #   # # # # #   #   #   #   #   # #     #       #
############# # # ##### ##### # # # # # # # # ### # ####### ### # # ########### #
#       #   #   #   #   #     # # #   # # #   #   #   #       #     #           #
# ##### # # ####### # ### ### # ##### ### ##### ##### # ############# ###########
#   #   # #     #   # #   # #   #   # #   #   #     # #   #     #   #       #   #
### # ### ##### # ### # # # ##### # # # # ### ##### # ### # ##### # ### ### ### #
#   #   #     # # #   # #   #     #   # #     #     #   # # #     #   # # #     #
# ##### ##### # # # ### ##### ######### ##### # ####### # # # ####### # # ##### #
#   # # #     # # #     # #   #         #   #   #   #   #   # # #   #   #       #
# # # # ### ### ######### # ### ######### # ##### # # ### ### # # # # ###########
# #   # #   # #       #   #   #           #       # #   #   # #   # # #         #
# ##### # # # ### ##### # # # ##################### ### ### # ##### # # ####### #
#     # # # #     #     # # #       #     #     # #   #     # #   # # # #       #
# ##### # # ####### ##### ####### # # ### ### # # # ##### ### # # # # # # #######
# #       #   #       # #   #     #     #   # # #   #     #   # # #   # #       #
# # ########### ##### # # # # ############# # # ##### ##### ### ########### # ###
# #   #     #   #     #   # #   #   #       # # #     #   #     #     #     #   #
##### # ### # ### ######### ### # # # ##### ### # ####### ##### # ### # ##### # #
#     # #   #   #     #   #   #   # #   # #   # # # #     #     #   #   #     # #
# ### ### ##### # ##### # ##### ### # # # ### # # # # ##### ######### # ####### #
# # #     #   # #   #   #   #   #   # # #   # #       #     #     #   # #       #
# # ### ##### # ### # ##### # ### ##### ### # ########### ### ### # ##### #######
#     # #     # #     # #   # # # #   # #   #           # # #   #   #     #     #
##### # # ### # # # ### # ### # # ### # # ############# # # # ### ### # ##### # #
# #   # #   #   # # #   #     # #     # # #       # #   #     #   # # #       # #
# # ##### ####### # # ### ##### ##### # # # ##### # # ######### ### # # #########
# #     #   #     # #   # #     #   # # #       #   # #   #   #   # # # # #     #
# ##### ### # # ####### ### ##### ### # # ##### ##### # # # # ### # # # # # ### #
#     #     # #       #   # #   # #   # #   # #     # # #   #     #   #   #   # #
# ### ############### ### # # # # # ### ### # # ### # # ##################### # #
# #         #   #   #   #   # #     #   #   # #   # # # #     #   #     #     # #
# # ######### # # # ### ### ######### ### ### ### ### # # # # ### # ### # ##### #
# # # #     # #   #       #   #   #   #   #       #   #   # #   #   # #   #     #
# # # # ### # ######### # ### # # # ### ########### ####### ### # ### ### # #####
# #   # #   #         # #   #   # # # #           #   #   #   # #   #   # # #   #
# ### # # ##### ##### ##### ### # # # ########### ### # ##### # ### # # ### # # #
# # #   #     # #   #   # # #   # #     #       # #   #       #     # #   #   # #
# # ### ##### ### # ### # # # ##### ### ####### # # ### ############# ### ##### #
#   #   #     #   #     #   #   #   # #   #   #   # #   #           # # #     # #
##### ### ##### ############### # ### # # # # # ### ##### ####### ### # # # # # #
#       #                     #     #   #   #   #         #           #   # #   #
############################### #################################################

