########################################################################### #####
#     #             #   #   # #           #     #         #         #     #     #
# ### # # ######### # # # # # # ##### ### # ### # ######### ### ### # ### ##### #
# # #   # #   #   #   # # #     #     #   # #   #           # # #   #   #       #
# # # ##### # # ######### # ######### # ### # ############### # # ##### #########
# #   #     #   #         # #     #   # #   # # #   #         # # #     # #     #
# ##### ######### ######### # ### # # # ### # # # # # ####### # # # # ### # ### #
# #   # #       #   # #     # #   # # #   # # #   # #   #     # #   # #     # # #
# # # # ### ### # # # # ##### # # ### # # # # # ### ### ### ### ####### ##### # #
# # # #   # #   # # #   # #   # # #   # #   # # #   #     # #     #   #       # #
# ### ### # # ### # ### # # ### # # ####### # # # ####### # ##### # # ######### #
#   #   #   #   # # #   #   #   # # #     # # # #     #   #       # #     #     #
### ### ##### # ### # ### ####### # # ### ### # # ### ##### ####### ##### # #####
# #     # #   #   # #   # #   #     # # #   #   #   #       #   #   #   #   #   #
# ##### # # # ### # ### # # # # ##### # ### ##### # ######### # ### # # ####### #
#     # #   #   #   #   # # # #   #   #   #     # #     #     #   #   # #       #
# ### # ####### ### # ### ### ### # ##### ##### ####### # ####### ##### # ##### #
# #   # #     # #   #   #     # #   #   #   #   #   #   #   #   #       # #     #
### ### # ### # # ##### ### ### ##### # # ### ### ### ##### # # ######### ##### #
#   #   # # # # # #     #   #   #     # # #   #     #   #     #   #   #       # #
# ### # # # # ### # ##### ### # ### ##### # ### ### ### # ####### # # ####### # #
# #   # # # #     #     #   # #     #   #   #   #   #   # #     # # #   #     # #
# # # ### # ########### ### # ####### # ##### # ### # ##### ### # # ### # #######
# # # #   #     #     #   # #   #     # #     # #   #   #   # #   #   #   #     #
# # # # ####### # ### ### # ### # ##### # ##### # ##### # ### ####### ### # ### #
#   # #         # #   #   # # #   #   # # #   # # #   # #     #   # # # #     # #
# ### ##### ####### # # ### # ### # # # # # # ### # # ### ##### # # # # # ### # #
#   # #   # #       # #   # # #   # #   # # #   # # #   # #     #   #   #   # # #
### # # # ### ####### ### # # # # ####### # ### # # ### # # # ############# # # #
#   # # #   #   #     #   #   # #         # #   # # # #   # # #         #   # # #
# ### # ### ### # ##### ####### ########### # ### # # # # # ### ####### # ##### #
# #   #   #     #   #   #     # #       # # #       #   # #     # #   # #   #   #
# ####### ######### # ### ### # # ##### # # ############### ### # # # # ### # ###
#   #   #         # # #   #   # #     #   #         #   #   #   # # # #   # #   #
# # # # ### ####### # ### # ### ##### ### ######### # # # ### ### # # ### # ### #
# #   #   # #     # #     # #       # #   #       #   #     # # #   #   # # # # #
# ##### # ### ### # ### ### # ####### ### # ############### # # ### ### # # # # #
#     # #       # #   # #   #   #     #   #       #     #   #     # # #     # # #
####### # ####### # ### # # ##### ##### ######### # ### # ######### # ####### # #
#   #   # #     # #     # #     #   # #   #     #     # # #   #   #   #         #
### # ##### # # # ####### ##### ### # # # # ### ####### # # # # # ##### #########
#   #     # # #   #       #   # # # # # # #   #   #   #   # #   # # #         # #
# # ##### # ### ### ##### ### # # # # # # # # ##### # # ####### # # # ####### # #
# #     # #   #   #   # #     #   #   # #   #       # # #       #   #   #   # # #
# ### ### ### ####### # ####### # ##### ############# # ### ########### # ### # #
#   #   #   # #   #   #       # # #     # #     # #   #   # #         #     #   #
### ### ### # # # # ####### # # # # ##### # # # # # ##### # # ### ######### #####
#   # #     #   # #       # # # # #   #     # #   #     #   # #   #       #     #
# # # ########### ##### # ### # ##### # ##### ######### ##### ### # # ### ##### #
# # #     #       #   # #   # #       #     # #     # #     #   #   #   #     # #
# ##### ### ####### # # ### # ############# # # ### # ### # ### ######### ### # #
# #     #   #     # #   #   # #         # # #   #   #     #     #   #     #   # #
# # ##### ### ### # ##### ### # ### ### # # ######### ########### ### ######### #
#   #   #   #   # # #   #     #   #   #   #           #     #   # #     # #     #
##### # ### ### # # # # ######### ### ################# # ### # # # # # # # ### #
#     #         #   # #             #                   #     #     # #     #   #
##################################################################### ###########

