### #############################################################################
#   # #               #     #     #         #       #     #             #       #
# # # # # ########### # ### # ### # ######### ### # # ##### # ######### ### ### #
# #   # #   #   #   #     # # #   #     #     #   # # #     #       # #   # #   #
# ##### ### # # # # ####### # # ####### # ##### ### # # ########### # # # ### # #
#     # # #   #   #     #   # #       # # #     # #     # #       #   # #     # #
##### # # ##### ######### ##### ##### # # # ##### ##### # # # ####### # ####### #
#   #   #     # #   #   # #   #   # # #   # # #       # #   #         # #       #
# # ##### ### # # # # # ### # ### # # # ### # # ##### ### ############# # #######
# # # #   #   # # #   #   # #   # # #   #   # #     #   # # #     #   # #   #   #
# # # # # # ### # ####### # ### # # ####### # ##### ### # # # # # # # # ### # # #
# #   # # # #   #     #   #   #   #         #       #   # #   # # # # # #   # # #
# ##### # # # ####### # ##### ####################### ### ##### # # # # # ##### #
# #     # #     #     #             #     #     # #   #       # # # # # #       #
# # ##### ####### ################# # ### # ### # # ### ####### # # # ### # #####
# # # #   #     # #   #         # #   #   # #   # #   #   #     #   #   # #     #
# # # # ### ### # # # # ####### # ##### ### # ### ### # # # ##### ##### # ##### #
# # #   # # # #   # #   #     # #   #     # #     # #   # #   #   #   # #     # #
# # ##### # # # ### # ##### ### # ### ##### ### # # ####### # ##### # # # ### ###
# #     # # #   #   # #   # #   #     #     # # # # #     # #   #   #   #   #   #
# ##### # # ##### ### # # # # ######### # # # # ### # ### # ### # # ####### ### #
#     #     #     # # # # #   #       # # # #   #     #   #   # # # #   # # #   #
##### ####### # ### # # # ### ### ### ### # ##### ##### ####### # ### # # # # ###
#     #     # #     #   #   # #   # #     # #     # #   #     # #     # #   #   #
# ##### ### # ############# ### ### # # ##### ### # # ### ### # ####### ##### # #
# #       # #     #   #   # #   # # # #       # # # #     # #   # #     #   # # #
# # ##### # ### # ### ### # # # # # # ##### ### # # ##### # ##### # # ### # ### #
# #   #   #     #     #   #   # # # #     # #   #   #   # # #       #   # #     #
# ### # ############### ####### # # # ### ### ##### ### # # # ######### # #######
#     # # #           #   #     # # # #   #   #   # #   # # #     #     # #   # #
##### # # # ####### # ### ####### # # # # # ### # # # ### # ####### ##### # # # #
#   # # # #     #   #     #     #   # # # #   # #   #   # # #         # # # #   #
# # # # # ### # ########### ### # ### # ##### # ####### # # # ####### # # # ### #
# # # #   #   #   # #       #     #   #     #   #       # # #     # #   # #   # #
# # ##### ####### # # ### ################# # ####### ##### ### # # ##### ### # #
# #   #   #     #     #   #       #         #       #       #   #       #     # #
# ### # # # ### ####### ### ##### # ############### ####### # ################# #
# # #   # #   #   #       # #   #   #   #     #     #     # #   #           #   #
# # ######### # ### ####### # # ####### # # ### ### # ##### ### # ######### # ###
#   #     # # #   # #   #   # #   #     # #       # # #   #     #   #   #   #   #
# ### ### # # # # # # # # ### ### # ##### # ####### # # # ######### ### # ### # #
# #   # #   # # #   # #   # #   #   #     # #       #   #   #       #   #     # #
# # ### ### # ##### # ##### ### # ##### ### # ######### ### # ####### ######### #
#   # #   # #     # #       #   #       # # #   #       # #       # # #     #   #
### # # # # ##### # ####### ############# # # ### ####### ####### # # # ### # ###
# # #   #   #     #   #   # #     # #     # #     #   #   #   #       # # #   # #
# # ####### ####### # # ### # ### # # ### # ######### # ### ### ####### # ##### #
# # #     # #   # # # # #   # # #     #   # # #   #   #   #   #   #     #   #   #
# # # # ### # # # # # # # # # # ####### # # # # # # ##### ### ### # ##### ### # #
#     # #   # #   # # #   #   # #     # # #   # #   #   # #   # # # #       # # #
######### ##### # ### # ####### # ### # ####### # ### # # # ### # # ##### # # # #
#   #   # #   # #     #   #   #   # # #   #     # #   #   #   # # # #   # #   # #
# # # # # # # # ####### # # ### ### # ### # ##### # ######### # # # # # ####### #
# # # # #   # # #   #   # # #   #   # # #   #   #     #   # #   # #   #         #
# # # ####### # # # # ### # # ### # # # ##### # ##### # # # # ### ############# #
# #             # #     #   #     # #         #         #   #     #             #
### #############################################################################

