####### #########################################################################
#               #   #         #   #     #   #     #     #   #   #     #     #   #
##### ######### # # ####### # # # # ### # # # ### # ### # # ### # ### # # ### # #
#   #   #       # #     #   # # #   # #   # # #   # # # # #     #   #   # #   # #
# # ##### # ##### ##### # ### # ### # # # # ### ### # # # # ####### ##### # #####
# #       #     #     #   # # #   #   # # #       #   # # # #   #   #     #     #
# # ########### ####### ### # # # ####### ############# # # # # # # ######### # #
# # #   #     #     #   # #   # #       #             # # #   #   # #     #   # #
### # ### ### ##### # # # ####### ### # ############# # # ####### ### ### # ### #
#   #       #   #     # #   #   # # # # #       #   # # #       # #   # # # #   #
# ########### ### ####### # # # # # # # # ##### # # # # ####### # # # # # # # # #
#     #     #     #       # # # # # # # #   #   # # # #   #   # # # #   #   # # #
##### # ### ####### ####### # # # # # # ### # ##### # # # # # # # # ######### # #
#     #   #     #   #     #   # #   # #     #       #   #   #   #   #       # # #
# ####### ##### # # ### ### ##### # ############################### ####### # # #
# #       # #   # #     #   #   # #     #     #   #   #           #   #   # # # #
# # ##### # # ### ####### ### # ####### # ### # # # # # ####### ##### # ### # # #
#   #   # # #     #     #     # #     # # #   # # # #   #       #   #       # # #
##### # # # ####### ### ####### # ### # # # ### ### # ########### # ######### ###
#     #   #   # #   # #   #   #   # #     # #       # #       #   #   #         #
# # ####### # # # ### ### # # # ### ####### ####### # # ##### # ##### ######### #
# #   #     # # # #     #   # # #   #     #   #     #   #   #   #     #   #     #
##### # ##### # # # ### ##### # # ### ### ### ##### ### ### ##### ##### # ### ###
#   #   #   # #   # # # #     # #     # #     #   #   #   #         #   #     # #
# # ##### # # # ### # # # ##### ##### # ####### # ### ### ########### ######### #
# #       # #   #   # # # #   #     # #     # # #   # # # #   #       # #       #
# ######### ##### # # # # # # ####### # ### # # ### # # # # # # ##### # # # #####
#     #   #       # #   # # # #   #     #   # #   #   #     #   #   # # # #     #
##### # # ### ######### ### # # # # ######### ### ##### ######### # ### # ##### #
#     # #     # #     # #   # # #     #   # #   #   #   # #     # #   #     # # #
####### ##### # # ### # # # # ######### # # # ##### # # # # # ### ### ##### # # #
#     #     # #   #     # # # #     #   #   #       # # #   #   #   #     # #   #
# # ####### # ##### ##### ### # ### # ### ########### # ##### # ### ### # ### ###
# # #   #   # #   #     #   # # #   #   #         #   # #   # #     # # #     # #
# ### # # # ### # ####### # # # # ##### ######### # ### # # ##### ### # ####### #
#     # # # #   #         # # # #       #       #   #     # #   # #   # #       #
# ##### # ### ############# # # ######### ##### ##### ##### # # # # ### # #######
#   # #       #   #   #   # # #         # #     #     #   #   # # #   #   #     #
### # ### ### # # ### # ### # # ####### # ### ######### # ####### ### ### # ### #
#   #   #   #   #     #     #   # #   # #   # #         #   #   # #     # #   # #
# ##### ### ################### # # # # ### # ### ######### # # # # ### # ### # #
# #     # # #   #         #       # #     # #   # #     #   # # # # #   # #   # #
# # ##### # # # # # ### ### ####### ####### ### # ##### # # # # # # # ##### ### #
#   #       # #   #   #     # #   #   #       # #   #   # #   # #   #   #   #   #
##### ### ########### ####### # # ### # ####### ### # ### ##### ####### # ### ###
#   #   #     #     #   #       # # # #   #     #   # #   #   #     #   # # #   #
# ##### ##### ### # ### # ####### # # # # # ##### ### # ### # ##### # ### # # # #
#   #       #   # #   # #       #   # # # #   # #     #   # #   #   # #     # # #
### # ### ##### # ### # ######### ### # ### # # ####### ### ### # ### # ####### #
#   #   # #   # #   #     #       #   # #   # #   #   #   #   # #   # #       # #
# ####### # # # ########### # ####### ### ### # # # # ### ### # ### # ####### # #
#         # #   # #   #     # #     #   # #   # # # #   # # # #   #   #     # # #
########### ##### # # # ##### # ### ### # # # ### # ### # # # ### # # ##### # # #
#           #   # # #   # #   #   # # #   # #   #   #     #   #   # # #   # # # #
# ########### # # # ### # # # ### # # # ####### # ############# ### # # # # # # #
#             #     #   #   #     #   #       #                 #   #   #     # #
########################################################### #####################

