####################################################################### #########
# # # # # # # # # # # # # # # # #     # # # # # #   # # # # # #   # # # # # # # #
# # # # # # # # # # # # # # # # # # # # # # # # # # # # # # # # # # # # # # # # #
# # # # # # #   # # #   # # # # # # # # # # # # # # # #   # # # # # # # # # # # #
# # # # # # ### # # # # # # # # # # # # # # # # # # # # ### # # # # # # # # # # #
# # # # # #   #   #   # # #   # # # # # # # # # # #   # # #   # #   # # # # # # #
# # # # # # # ### # # # # # # # ### # # # # # # # # # # # # # ### # # # # # # # #
# # # # # # # # # # # # # # # # #   # # # # # # # # # # # # # # # # # # # # # # #
# # # # # # # # # # # # # # # # # # # # # # # # ### # # # ### # # # # # # # # # #
#   # # # # # # # # # #   # # #   # # # # # # # # # # # # # # # # # # # # #   # #
# # # # # # # # # ### # # ### # # ### # # # # # # # # # # # # # ### # # # # # # #
# #   # # # # # # # # # # # # # # #   # # # # #     # # # # # # # #   # # # # # #
# ### # # # # # # # # # # # # # # # # # # # # # # # # # # # # # # # ### # # ### #
# # # # # # # # #   # # # # # # # # # # #   # # # # # #   # # # # # # # #   # # #
# # # # # # # # # # # # # # # # # ### # # # # # # # # # # # # # # # # # # # # # #
# #   # # # #   # # # # # #   # # # #     # # # # # # # # # # #   # # #   # # # #
### # # # # # # # # # # # # # ##### # ### # # # # ### # ### # # # # # # # ### # #
# # #   # # # # # #   # #   # # # # # # # #   # # # # # # # #   # #   # # # # # #
# # # # # # # # ### # # # # # # # # # # # # # # ### # # # # # # ### # ### # # # #
# # # # # # # # # # # # # # #   # # # #   # #   # # # # #   # # # # # #   #   # #
# # # # # # ### # # # # ### # # # # # # ### # # # # # # # # # # # # # # # # # # #
# # # # # # # # # # # # #   # # # #   # #   # # # #   # # #   # # # # # # # # # #
# # # # # # # # # # # # # # # ### # # # # # # # # ### # ### # # # ### ### # # # #
# # # # # # #   # # # # # # # # #   # # # # # # #     # # # # # # # # # # # # # #
# ##### # ##### # # # # # # # # # ### # # # # # # # # # # # # # # # # # # # ### #
# # # #     # # # # # # # # # # # # # # # # # # # # # # # # # #   # # #   #   # #
# # # # # # # # # # ##### # # # # # # ##### # # # # # # # ##### # # # # # # # # #
# # # # # # # # # # # # # # # # # #   # # # # # # # # # # # # # #   #   # # # # #
# # # ### # # # # ### # # # # # ### ### # ### # # # # # # # # # # # ### # # # # #
# # # # # # # # # # # # # # #   # # # # #   # # # # # # # # #   # #   # # # #   #
# # # # # ### # # # # # ### ### # # # # # # # # # # # # # # # # ### # # ### ### #
# #   #   # # # # # #   # # # #   # # #   # # # # # # # #   # # #   # #   # # # #
# # # # # # # # # # # # # ### # # # # # # # # # # # # # ### # # # # # # # ### # #
# # #   # # # #   # # #   # #   # #   # # # # # # # # # # #   # # # # # # # # # #
# # # ### # # # # # # # # # # # # # # # # # ##### # # # # # # # # # # # # # # # #
#   # # # # # # # #   # # #   # # # # # # # # # # # #   # # # # # # # # # #   # #
# # # # # # # # # # # # # # # # ### ### # # # # # # # # # # # # # # # # # # # # #
# # # # # # # # # # # # # # # # # # # # # # # # # # # # # # # # # # # # # # # # #
# # # # # # # ### # # # # ##### # ### # ### # # ### # # # # # # # ### # # ### # #
# # # # #   # # # # # # # # # # #   # # # # # # # # # # # # # # # # # # # # # # #
# # # # # # # # # # # # # # # # ### # ### # # # # # ### # # # # # # # # # # # # #
# # # #   # #     # # # # # # # # # # # # # # # # # # #   # # # # # #   # # # # #
# # # # ### # # # # # # # # # # # # # # # # # # # ### # # # # # # # # ##### # # #
# # # # #     # #   # # # # #   # #   # # # # # # # #   #   # # # # # # # # # # #
# # # # # # # # # # ### # # # # # ### # # # # # # # # # # # # # # # # # # # # # #
# # # # # # # # # # # # # # # # # # # # # #   # # # # # # # # # # # # # # #   # #
# ##### # # # # # # # # # # # # # # # # # # # # # # # # # # # # # # # # # ### # #
# #   # # # # # # #   # #     #     # # # # # # # # # # # # # # # # # # # # #   #
# # # # # # # ### # # ### # # # # # # # # # # # # # # # # # ### # # # # # # # # #
# # #   # # # #   # # # # # # # # #   #   # #     # # # # # #   # # #         # #
# # # # # # ### # ### # # ### # ##### # # # # # # # # # # # # # # # # # # # # # #
# # # # # # # # # #   # # #   #   # #   #   # # #   # # # # # # # # # # # # # # #
# # # # # # # # # # # # # # # # # # # # # ### # # ### # # # # # # # # # # # # # #
# # # # # # # # # # # # # # # # # # # # # #   # #   # # # # # # # # # # # # # # #
# # # # # # # # # # # # # # # # # # # # # # # # # # # # # # # # # # # # # # # # #
# # # # # # #   # # # #   # # # # #   # # # # # # #   # # # # # # #   # # # # # #
####################################### #########################################

