################################################### #############################
# # # # # # # #   # # # # #   #   # # # # # # # # # # # # # # # # # # # #   # # #
# # # # # # # ### # # # # ### ### # # # # # # # # # # # # # # # # # # # # # # # #
# # #     # # # # #     # # # # # # # # # # # # # # # # # # # # # #   # # # # # #
# # ### # # # # # # # # # # # # # # # # # # # # # # # # # # # # # # ### # ### # #
# # # # #   # # # # # # # # # # # # # # #   #   # # # # # # # # # # #   # # # # #
# # # # ### # # # ### # # # # # # # # # # # # ### # # # # # # # # # # # # # # # #
# # # # #   # # # # # # # # #   # # # # # # # #     # # # # # # # # # # # # # # #
# # # ### # # # # # ### # # # # # # # # # # # # ### # # # # # # # # # ### # # # #
# #   # # # # # # # # # # # # # #   # # # # # # #   # # # # # # # #   # # # # # #
# # # # # ### # # # # # # # # # # # # # ### # # # # # # # # # # # # ### # # # # #
# # # #   # #     # # # # # # # # # # #   #     # # #     # # # # # #   # # # # #
# ### # # # # ### # # # # # ### # # # # # # # # # # # # # # # # # # # # # # # # #
# # # # # # # # # #   # # # # # # # # # #   # # # # # # # #   # #   # # # # # # #
# # # ### # # # # # # # # # # # # # # ### # # # # # ### # # # # ### # ### # # # #
# # # # # # # #   # # # # # # #   # # # # # # # # #   # # # # #   # # # # # # # #
# # # # # # # # # # # # # # # # # # # # # # # # # # # # # ### # # # # # # # # # #
#     #   # # # #   #     #   # # # # # # # # # # # # # #   # # # # # # # # #   #
# # # # # # # ### # # # # # # # ### # # # # # # # # # # # # # # # # # # # # # # #
# # #   # # # # # # # # # # # # #   # # # # # # # # #   # # # # # # # # # # # # #
# # # ### # # # # # # # # # # # # # # # # # # # # # # # # # # ### # # # # # # # #
# # # # # # # #   # # # #   #   # # # # # # # # # # # # # #     # #   # # # # # #
# ### # # # # # # # # # ##### # # # # # ### # # ### # # # # # # # # # # # # # # #
# # # #   # # # # # # # # # # # # # # #   # # # # # # # # # # #   # # # # # # # #
# # # ### # # # # # ### # # # # # # # # # # # # # ### # # # # # # ### # # # ### #
# #   # #   # # # # # # # #   # # # #   #   # # # #   # # # # # # # # # # # # # #
# # # # # # ### # # # # # # # # ### ### # ### # # # # ### # # # # # # # # # # # #
# # # # # # # # # # # # # # # # # #     # # # #   # # # # # # # # # # # # # # # #
### # # # # # # # ### # # # # # # # # # # # # # # # # # # # # # # # # # # # # # #
#   # # # # # # #   # # #   # # # # # # #   # # # # # #   # # # # # # # # #     #
### # # # # # # # ### # # # # # # # # # # # # # # # # # # # # # # # # # # # # # #
# # # # # # # # # # #   # # # # # # # # # # # # # # # # # # # # # # # # # # # # #
# ### # ### # # # # # ### # # # # # # # # # # # # # # # # # # # # # # # # # # # #
#   # #   #   # # # # # # # # # # # # # # # # # # # # # # # # # # # # # # # # # #
# # ##### # # # # # # # # # ### # # # # # # # # ### # # # # # # # # # # # ### # #
# #   #     # # # #   # # # #   # # # # # # # # #   # # # # # # # # # # # # # # #
### # # # ### # # # # # # # # # # # # # # # # # # # ##### # # # # # # # # # ### #
# # # # # # # # # # # # # # # #   # # # # # # # # # #     # # # # # # # #   # # #
# ### ### # # # # ### # # # # # # # # # # # # # # # # # # # # ### # # # # # # # #
# # # # # # #   # # # # # # # # # # # # # # # # # # # # # # #   # # # #   # # # #
# # # # # # # # # # # # ### # # # # ##### # # # # # # # # # # # # # # ##### # # #
# # # # # # # # # # # #   # # # # # # # # # # # # # # # # # # # # # # # # # # # #
# # # # # # # # # # # # # # ### # # # # # # # # # # # # # # # # # # # # # # # # #
# # # # # #   # # # # # # # # # # # #     # # # # # # # # # # # # # # # # # # # #
# # # # ### # # # # # # # # # # # # # # # # # ### # # # # # # ### # # # # # # # #
#       # # # # # # # # #   # # # # # # # # # # # # # # # # # # # #   # # # # # #
# # ### # # # # # # # # # # # # # # # # # # # # ### # # # # # # # # # # # # # # #
# # #     # # # # # # # # # # # # # # # # # # # # # # # # # # # #   # # # # # # #
# # # # # # # # # # # # ### # # # ### # ### # # # # # # # # # # # # # # # # # # #
# # # # # # # # # #   # #   # # # # # # # # # # # # # # # # # # # # #           #
# # # # # # # # # # # # # # # # # # # # # # # # # # # # # # ### # # # # ##### # #
# # # # #   # # # # # # # # # # # #   # #   # #     # # # # # # # # # #     # # #
# # # # ### # # # # # ### # # # # ### # # # # # # # # # # # # # # # # # # # # # #
# # # # # # # # # # # #   #   # # #   # # # # # # # # # # # #     # # # # # # # #
# # # # # # # # # ### # # # # # # # # ### # # # # # # # # # # # # # # # # # # # #
# # # # #   # # # #   # # # # # # # # #   # # # # # # # # # # # # # # # # # # # #
################################# ###############################################

