########################### #####################################################
# # # # # # # # # # # # # # # # # #   #   # # # # # # # # #   # # # # # # # # # #
# # # # # # # # # # # # # # # # # # # # # # # # # # # # # ### # # # # # # # # # #
# # # # # # # # # # #   # # # # # # # # # # # # # # # # # # # # # # # # # # # # #
# # # # # # # # # # ### # # # # # # # # # # # # # # # # # # # # # # # # # # # # #
# # # #   # # # # # # # #   # # # # # # # #       # # # # # # # # #     #   # # #
# # # # # # # # # # # # # ### # # # # ### # # # # # # # # # # # # # # # # # # # #
# # # # # # # # #   # # # # # #     # # #   # # # # # # # # # # # # # #   # # # #
# # # # # # # # # # # # # # # # # ### # # # # # # # # # # # # # # # # # # ### # #
# # # # # # # # # # # # # #   # # # # #   # # # # # #   # #     # # # # # # # # #
# # # # # # # # # # # # # # ### # # # ### ### # # # # # # # # # # ### # ### # # #
# #     # # # # # # # # #   #   # # #   # # # # #   # # # # # # # # # # # # # # #
# ### # # # # # # # # # # # # # # # ### # # ### ### ### # ### # # # # # # # # # #
#   # # #   # # # # # # # # # # # # #   # # # # # #   # # #   #       # # # # # #
### # # # # # # # # # # # # # # # # # # # # # # # # # # # # # # # # # # # # # # #
# #   # # #   #   # # #   #   # # # # # # # # # # # # # # # # # # # # # # # #   #
# # # # ### # # # # # # ### # # # # # # ### # ### ### # # # ### # # # # # # # # #
# # # # # # # # # # # # #   # # # # # # # # # # # # #     # # # # # # #   # # # #
# # # # # # # # # # # # ####### # # # ### # # # # # # # # ### # # # # # ### # ###
# # # # # # # # # # # # # # # # # # # # #     # # # # # # # # # # # # # # # # # #
# ##### # # # # # # # # # # # # # # # # # # # # # # # ### # # # # ##### # # # # #
# # # # # # #   # # # # #   # # # # # # # # #   #   # # # # #   # #   # # # # # #
# # # # # # # # # # # # # # # # ### # # # # # # # # # # # # # # # ### # # # # # #
#   # # # # # # # # #   # # # # #   #   # # # # # #   #     # # # # # #   # # # #
# # # # # # # # # # ### # # # # ### # # # ##### # # # # # # # # # # # # # # # # #
# # #     # # # # # # # # #   # # # # # # #   #   # # # # # # # # # # # # # # # #
# # # ##### # # # # # ### # # ### # # # ### # # # # # # ### # # # # # # # # # # #
# # #     # # # # # # # # # # # #   # #   # # # # # # # # # # # # # # # # # # # #
### # # ### # # ### # # # # # # # # # # # # # ### ##### # # ### # # # ### # # # #
# # # # # # # # # #       # # #   #   # # # # # # # # # #   # # # # # # # # # # #
# # # # # # # # # # # # # # # # # # # # # # # # # # # # # # # # # # # # # # # # #
#   # # # # # # # # # # # # #   # # # # #   # # # # #   # #     # # # # # #   # #
### # # # ##### # # ### # # # # # # # # # # ### ### # # # # # ##### # # # # ### #
# # # #   #     # # # # # # # # # # # # # # # # # # # # # # # # # # #   #   # # #
# # # # # ### # # # # # # # ### # ### # # # # # # # # # # # # # # # # # ### # # #
# #   # # # # # # # # # # # # # # #   # # #       # # # # # # # # # # #   # # # #
# ### # # # # ### # # # # # # # # # # ### # # # # # # ### # # # # # # # # # # # #
# #   # # # # # # # # # # # # # # # # # # # # # #   # # # # # #   #   # #   # # #
# # # # # # # # # # # # # # # # # # # # # # ### # # # # ### # # # # # # # # # # #
# # # # # # # # # # #   # # #   # # # # # # # # # #   #   # # # # # # # # #     #
# # # ### # # # # # # # # # # # # # # # # # # # # ### ### ### ### # # # # ### # #
#   # #   #   #   # # # # # # # # # # # # # # # # #   # #   # #     # # # # # # #
# # # # # # # ### # # # # # # # ### # # # # # ### # # # # # # ### # # ### # # # #
# # # # # # # # # # # # # # # # # # # # # # # # # # # #   #   #   # # # # #   # #
### # # # # ### # ### # # # # # # # # # # # # # # # # ### # # ### # # # # # # # #
# # # # # # #     # # # # # # #   # # # # # #     # # #   # # # # # # #   # # # #
# ### # # # # ### # ### # # # # ### # # ### # # # # # # # # # # # # ### # # # # #
# # # # # # # # # #     # # # # # # # #   # # # # # # # # # # # # # # # # # # # #
# # # # # # # # # # # # # # # # # # # # # # # # ### # # # # # # # # # # # # # # #
# # # # # # # #   # # # # # # # #   # # # # # # #   # # # # # # # # # # # # # # #
# # # # # # # # # ### # # # # # ### # # # # ##### # # ### # # # # ### ### # # # #
# # # # # # # # # # # # # # # # #   # # #   # # # # # #   # # # #   #     # # # #
# # # # # # # # # # # # # # # # # # # # # # # # # # # ### # # # # # # # # # # # #
# #   # # # # # #     # # # # # # # # # # # #     # # # # # # # # # # # # # # # #
# # # # # # # # # # # # # # # # # # # # # # # # # # # # # # # # # # # # # # # # #
#   # # # # # # # # # # # # # # # # # # # # # # # # # #   # # #   # # # # # # # #
################################### #############################################

