##################################### ###########################################
# # # # # # # #   # # #       # # # # # # # # # # #     # # # # # # # # # # # # #
# # # # # # # # # # # # # ### # # # # # # # # # # # # # # # # # # # # # # # # # #
# # #   # # # # # # # # # # # # # # #   # # # # # # # # # # # # # # # # #       #
# # # # # # # # # # # # # # ### # # # # # # # # # # # ### # # # # # # # # # # ###
#   # # #   #   # # # # #   # # # # # # # #   #     #   # # # # # # # # # # # # #
# # # # # # # ### # # ### ### # # # ### # # # # ### # ### # # # # # # # # ### # #
# # # # # # # # # # # #   # # # # # # # # # # # # # # # # #   # # # # # # # # # #
# # ### # # # # # # # # # # # # # # # # # ### ### ### # # ### # # # # # # # # # #
# # # # # # # # # # #   #   # # #   # # # # # # #   #   # # #   # # #   # # # # #
# # # # # # # # # # # # # # # # # # # # # # # # # # # # # # # ### # ### # # # # #
# #   # # # # # # # # # # #   # # # # # #   # # # # # # # # # # # # # # # # #   #
# # # # # # # # # # ### # # ### ### # # # # # # # # # # # # # # # # # # # # # # #
# # #   # # # # # # # # # # #   # # # # # # # # # # # # # # # # # # # #   # # # #
# # ### # ### # # # # # # # # # # # # # # # # # # # # # # # # # # # # # # # # # #
# # # # # # # #     # # # # # # # # # # # # # #   #   # # # #   # # # # # # # # #
### # # # # # # # # # # # # # # # # # # # # # # # ##### # # # # # # # # # # ### #
# # # # # # # # # #     # # # # # # # # # # # # # # #   # # # # # # # # #   # # #
# # # # # # ### # # # ### # ### # # # # # # # ##### # # # # # ### # # # # ### ###
# # # # #     # # # # # # # # # # # # # # # # # # #   # # # # # # # # # # #   # #
# ### # # # # # ### # # ### # # # # # # ### # # # # # # # # # # # # # # # # # # #
# # # # # # # # # # # # # # # # # # # # # #   # # # # # # #   # # # # # # # # # #
# # # # # # # # # # ### # # # # # # # # # # ### # # ### # # # # # # # # # # # # #
# #   #   # # # # # #   # # # # # # #   # # # # # # # # # # # # # # # # # # # # #
# # # # # ### ### ### # # # # # # # # # # # # # # # # # # # ### # # # # # # # # #
# # #   # # #   #   # #     # # # # # # # # #   # # # #   # # # # # # # #   # # #
# # # # # # ### # ### # # # # # # # ### # # # # # # # # # # # # # # # # # # # # #
# # # # # # # #     # # # #   # # # # #   # # # # # # # # # # # # # # # # # # # #
# # # ### # # # ### # # # # ### # # # # # # # ### # # # # # # # # # # # # ### # #
# # # # # # #   # # # # # # # # # # # # # # # # #   # # # # # #   #   # # # # # #
# ##### # # # # # # ### # # # # # # # # # # # # # # # ### # # # # # # # ### ### #
# # # #   # # # #   # # # # # # # #   # # # # # # # # #   # # # # # # # # # # # #
# # # # # # # # ### # # # # # # # # # # # # # # # # # # # # # ### # # # # # # # #
# # # # # # # # # # #   # # # # # # # # # #   # # # #   # # # # # # # # # # # # #
# # # # # # # ### # # # # # # # # # # # # # # # ### ### # # # # # # # # # # # # #
#   # # # #   # #     # # # # # # # #   # # # # # # # # # # # # #   # # # # # # #
# # # # # # # # # # # # ### # # # ### # # # # # # ### # # # # # ### # # # # # # #
# # # # # # # #   # # # # # # # # # # # # # # # # # # # # # # # # # # #   #   # #
# # # ### # ### # # # # # # # # # # # # # ### # # # # # # # # # # ### # # # # # #
# # # # # # #   # # # # # # # # # #   # # # #     # # # #   # # # # # # # # # # #
# # # # # # # # # # # # # # # # # # # # # # # # # # # # # # # # # # # # # # # # #
# # # # # # # # # # # # # # # #     # # #   # # #   # # # # # # # # # # # # # # #
# # # # ### ### # # ##### # # # # # ### # # # ##### # # # # # # # # # # ##### # #
# #   # #   # # # # # # # # # # # # # # # # # #   # # # # # #   # # # #   # #   #
# # # # ### # # # # # # # # # # ### # # # # # # # # # # # # # # # # # # # # ### #
# # # # # # # # # # # # # # #   #     # # # # # # # #   # # # # # # #   #   # # #
# # # # # # # # # # # # # # # # # # # # # # # # # # # # # # # # # # # ### # # # #
# # # # # # # # # # # #   # # # # # # # # #   # #     # # # # # # # # # # # # # #
# # # # # # # # # # # # # # # # # # # # # # # # # # # # # # ### # # # # # ### # #
# # # # # # #   # # # # #   # # # # # # # # # # # # # # # # # # # # # # # # # # #
# # # # # # # # # # # # # # # # # # # # # # # # # # # ##### # # # # # # # # # # #
# # #   # # # # # #   # # #   # # # # # # # # # # # # # # # # # # # # # # # # # #
### # # # # # ### # # # # # # # # # # # # # # # # # # # # # # # # # # # ### # # #
#   # # # # # #   # # # # # # # # # # # # # # # # # # # # #                     #
# # # # # # # # # # # # # # # # # # # # # # # # # # # # # # # # # # # # # # # # #
# # # #     # # # # # # # # # # # # # # # # # # # # # #     # # # # # # # # # # #
################### #############################################################

