####### #########################################################################
# # # # # # # # # # # # # # # # # #   # #   # # # # # #   # # # # # # #   # # # #
# # # # # # # # # # # # # # # # # # # # ### # # # # # ### # # # # # # # # # # # #
#   #   # # # # # # # # # # #     # # # # # # # # # # #   # #   # # # # # # # # #
# # # # # # # # # # # # # # # ### # # # # # # # # # # # # # # # # # # ### # # # #
# # # # # # #   # # # # # # #   # # # # # # #   # # #   # # # # # # # # #     # #
# # # # # # # # # # # # # # # # # # # # # # ### # # # # ### # # # # # # # ### # #
# # # # # # # # # # # # # # # # # # # # # # # # # # # #   # # # # #   # # # # # #
# # ### # # ### # # # # # # # ### # ### # # # # # # # # # # # # # # # # ### # # #
# # # # #   # #   # # #   # # # # #   # # # # # # # # # # # # # # # #   # # # # #
# # # # # ### # # # # # # # # # # ### # # # # # # # # # # # # # # # # # # # # # #
# #   # # #   # # #   # # # # # #   # # # #   # # # # # #   # # # # # # # # # # #
# # # # # ### # # # # ### # ### # # # # # # ### # # # # # # ### # ##### # # # # #
# # # #   #   # # # # # # # #   # # # # # # # # # # # # # # # # # # # #   # # # #
# # # # # # # ### # # # # # # # ### # # # # # # # # ### # # # # # # # # # # # # #
# # #   # # # # # # #   # # # # #   # # # # # # # # # # # # # # # # # # # # # # #
# # # # # ### # # # # ### # # # # # # # # # # # # # # ### # # # # # # # # # # # #
# # # # # # # # # # # # # # # # # # # #   # #   # # # # # # # # # # # # # # # # #
# # # # # # # # # # ### # # ### # # # # # # # # # # # # ### # # # # # # # # # # #
# # # # #   # # # # # # # # #   # # # # # # # # # # # #   #   # # # # # # # # # #
# # # # # # # # # # # # # # # # ### # # # # # # # # # ### # ### # # # # # # # # #
# # # # # # # # #   # # # # # # # #   # # #   #   # # # # # # #   # # # # # # # #
# # # # # # # # # # # # # # # ### # ### # # ### # # # # # # # # # # # # # # # # #
# # # # # # # # # # # # # # # # # # # # #   #   # # # # # # # # # # # # # # # # #
### # ### # # # # # # # # # # # # # # ### # # # # # # # # # # # # # # # # # # # #
# # # # # # # # # # # # # # # # # # # # # # # # # # #   # # # # # # # # # # #   #
# # # # # # # # # # # # # # # # # # # # # # # # # # ### # # # # # # # ### # # # #
#   # # # #     # # # # # # # #   # #   # # # # #     # # # # # # # #     # # # #
# # # # ### # # # # # # # # # # # # ### ### ### ### # # # # # # # # # # # # ### #
# # # #     # # # # # # #     # # #   # # # # # #   #   #   # # # # # # #   # # #
# # # # # # # # # ### # # # # ### # # # # ### # # # ### # # # # # # # # # # # # #
# # # # # # # # #     # # # # # # # # # #   # # # # #   # # # # # # # # # # # # #
# # # # # # # # # # # # # ### # # # # # # # # # # # ### # # # ### # # # # # # # #
# # # # # # # #   # # # # # # # # # # # # # #   # # # # # # # # #   # # # # #   #
# # # # ### # # # # ### # # # # # # # # # # # ####### # ### # # # # # ### # # # #
# # # # #   # # # # #   # # # # # # # # # # # # # #   # #   # # # #   # # # # # #
# # ##### ##### # # # # # # # # # # # # ### # # # # # # ### # # # # # # ### ### #
# # # #   # # # # #   # # # # #   # # # # # # # # # # # # # # # # # # # # # # # #
# ### # # # # # # # # # ### # # # ### # # # ### # # ### # # # # ### ### # # # # #
# # # # # #     # # # #   # # # #       # #   # #       # # # # # # # # # # # # #
# # # # # # # # # # # # # # # ### # # # # # # # ### # # # # # # # ### # # # # # #
# # # # # # # # # # # # # #   # # # # # # # # # # # # # # # # # # # # #     # # #
# # # # # # # # # # # # # # # # # # # # # ### # # # ### # # # # # # # # # # # # #
# # # # # # # # # # # # # # # # # # # # # # # # # # # #   #   # # # # # # #   # #
### # # # # # # ##### # # # # # # # # # # # # # # # # # # # # # # # # # # # ### #
# # # # # # # #   # # # # # #     # # # #   # #     # # # # #   #   # # # #   # #
# # # # # # # # # # # # # # ### # # ### ### # # # # # # # # ### # # # # # # # # #
#     # # # # # # #   # #     # # # # #         # # # # # # # # # # # # # # #   #
# # # # # # ### # # # # # # # ### # # # # ### # # # # # # # # ##### # # # # # # #
# # # # # # # # # # # # # # # # # # # # # #   # # # #   #               # # # # #
# # # ### # # ### # # # # # # # # # # # ### ### # # # # # # # # # # # # # # # # #
# # #     # #     # # # # # # # # # # # #   # # # # # # # # # # # # # # # # # # #
# # ### # # # # # # # # # # # # # # # # # # # # # # # # # # # # # # # # # # # # #
# # #   # # # # # # # # # # # #   # # # # # # # # # # # # # # # # # # # # # # # #
# # # # # # # # # # # # # # # # # # # # # # # # # # # # # # # # # # # # # # # # #
# # # # # # # # # # # # # # # # # # #   # # #   # # # # # # # # # # # # # # # # #
############################################# ###################################

