######################################### #######################################
# # # # # # # #   # # #   # # # # # # #   # # # # # # # # # # # # # #   # # # # #
# # # # # # # # # # # # # # # # # # # ### # # # # # # # # # # # # # # # # # # # #
#     # # #   # # # # # # # # # # # # # # # # #   # # # # # # # # # # #   # # # #
# # # # # # # ### # # # # # # # # # # # # # # ### # # # # # # # # # # # # # # # #
# # # # #   # # # #   # # # # # # # # # #   # #   # # # # # # # # # # # # # #   #
# # # # # ### # # # # # # # # # # # # # ### # ### # # # # # # # # # ### # # # # #
# # # # # # # #     # # # # # # #   # # # # # # # # # # #   # # # # # # # #   # #
# ### # # # # ### # # # # # # # # # # # # # # # # # # # # # # # # # # ### # # ###
# # # # # # # #   # # # #   # # # # #   #   # # # # #   # #   # # #   # # # # # #
### # # ### # # # # # ### # # # # # ### # # # # # # ### # # # # # # # # # # # # #
# # #   # # # # # # # # # # #   # # # # # # # # # #   # # # # # # # # # # # # # #
# # # # # # # # # # # # # # ### # # # # ### # # # ### # ### # # # # # # # ### # #
# # # # # # # # # # # #   # # # # # # # # # # # # # # # # # #     # # # # # # # #
# # # # # # # # ### # # # # # # # # # # # # # # # # # # # ### ### # # # # # # # #
# # # # # # #   #   # # # # #   # # # # # # # #   # #   # # #   # # # # # # # # #
# # # # # # # # # # # # # # ### # # # # # # # # # # # # # # # ####### # # # # # #
# # # # #     # # # #   # #   # # # # #   # #   #   # # # # #   #   # # # # # # #
# # # # ### # # # # # ### # # # ### # # # # # # # # # # # # # # ### # # # # # # #
# # # #   # # # # # # # # # #   # # # # # # # # # #   #   # # #   # # # # # # # #
# # # # # ### ### ### # ### # # # # # ### # # # # # ### # # ### # # # # # # # # #
# # # # # # # # # # # # # # # # #   # # #   # # # # # # #   #   # # # #       # #
# # # # # # # # # # # # # # ### ### # # # # # # # # # # ### ### # # # # ### # # #
# # # # #     # # # # # # # # #   # #     # # # # # # # # # # # # # # # # # # # #
# # # # # # # # ### # # # # # # # # # # # # # # # # # # # # # ### # # ### ### # #
# # # # # # # # # # # #   # # # #   # # # # # # # # # # #     # #   # #   # # # #
# # # # # # # # # # ### # # # # # # # # ### # # # # # # # # # # # # # # # # # # #
# # # # # # # # # # # # #   # # # # # # # #   # # # # # # # # # # # # # # # #   #
# # # ### # # # # # # # # # # # # # # # # # # # # ### # # # # # ### # # # # # # #
#   # #   # # # # # # # # # #   # # # # # # # # # # # # # # # # # # # # # # # # #
# # # # # # # # # # # # # # # # ### # # # # # # # # # # # # # # # # # ### # # ###
# # # # # # # #   # #   # # # # # # # # #   # # # # #   # # # # # # # # # #   # #
# # # # # ### # # # # # # # ### # # # # # # # ### # # ### # # # # # # # # # # # #
# # # # # # # # #   # # # # #   # # # # # # # # # # # # # # #       # # # # # # #
### # # # # # # # # # # # # # # # # # # # # # # # # # # ### # # # # # # # # # # #
# # # # # # # # # # # # # # # # #     # # # # # # # # # # # # # # # #   # # #   #
# # # # # # # # # # ### # # # # ### # ### ### # # # # # # ### ### # # # # # # # #
# # # # # #   # # #   # # # # # # # # #   # # # # # # #   # #   # # # # # # # # #
# # # # ### # # # # # # # # # # # # # # # # # # # # # # # # # # # # # # # ### ###
# # # # #   # # # # # # # # # # # # # # # #     # # # # # # # # # #   #   # # # #
# # ### # # ### # # # # # # # # # # # # # # # # # # ### # # # # # # # # # # # # #
#       # # #   # # #   # # # # # # # # # # # # # #   # # # # # # # # # # # # # #
# # # # ### # # # ##### # # # # # # # ### # # # # ### ### # # # ### ##### # # # #
# # # # # # # # # # # # # # # # # # # # # # # # # # #   # #   # # # #   # # #   #
# # # ### # # ##### # # # # # # # # # # # ### # ### # # # ### # # ##### # # # # #
# # #   # # # #   #     # # # # #   # # # # # # # #   # # #   # # # # #       # #
# # # # # # # # # # # ### # ### # # # # ### # # # # # # # ##### # # # # # # # # #
# # # # # # # # #   # # # # # # # # # # # # # # # # # # #       #   # # # # # # #
# # # # # # # # ### ### # # # # # # ### # # ### # # # # # # # # # # # # # # # # #
# # # # #   # # #   #     # # # # # #   # # # # # # # # # # # # # # # # # # # # #
# ### # # # # ### # # # # # # # # # # # # # # ### # # # # # # # # # # # # # # # #
# #   # # # # # # # # # # #   # # # # # # # #   # # # # # # # # # # # # # # # # #
# # # ### # # # # # # # # # # # # # # # # # # # # # # # # # # # # # # # # # # # #
# # # # # # # # # # # # # # # # # # # #   #   #     # #   # # # # # # # # # # # #
# # # # # # # # # # # # # # # # # # # # # # # # # # # # # # # # # # # # # ##### #
# # #   # # # #   # # # # # # # # # # # #   # # # # # # # # # # # #     #     # #
############# ###################################################################

