############################################################# ###################
# #   # # # # # # # # # # # # # # # # # # # # # # # # # # #   # # #   # # # # # #
# # # # # # # # # # # # # # # # # # # # # # # # # # # # # # # # # # # # # # # # #
# # # #   # # # # # # # # # # # # # # # # # # # # # # # # # # # # # # #   # # # #
# ### ### # # # # # # # # # # # # # # # # # # # # # # # # ### # # # # # # # # # #
# # # # # # # # # # #   # # # # # # # # # # # # # # # # # #   # # # # # # # # # #
# # # # # # # # # # # # # # # # # # # # # # # # # # # # # # # # # # # # # # # # #
# # # #   # # # # # # # # #   # # # #   # #   # # #   # # # # # #   # # # # # # #
# # # # # # # # # # ### # # # # # # # # # # # # # ### # # # # # # # ##### # # # #
# # # # # # # # # # # #   # # # # #   # # # # # # # # #   # # # # #     # # # # #
# # # # # # # # # # # # # # # # # # # # # # # # # # # # # # # # ### # ### # # # #
# # #   # #   # # # # # # # #   # # # #   # # # # # # # # # #     # # # # # # # #
# # # ### # # # # # # # # ### # # # # # # # # # # # # # # ### # # # # # # # # # #
# #   # #   # # # # # # # # # #     # # # # # # # # # # # # # # #   # # #   # # #
# ##### # # # # # # # ### # # # # ### # # # # # # # # ### # # ### # # # ### # # #
# # # # # # # # # # # # # # # # # # # # # # # # # # # # # # # # # # # # #   # # #
# # # # ### # # # # # # # # # # # # # # # # ### # # # # # # # # # # # # # # # # #
#   #   #   # # # # # # # #   # # #   # # # # # #   # # # # # #   # #   # # # # #
### ### # # # # # # # # # # # # # # # ### # # # # # # # # # # # # # # # # # # # #
#   # # # # # # # # # # # # # # # # # # #   # # # # #   # #   # # # # # # # #   #
# # # # ##### # # # # # # ##### # # # # # # # # # # ### # # # # ##### ##### # ###
# # # # # #   # #   # #   # #   # # # # # # # # # # # # # # # # # # #     # # # #
# # # # # # # # # # # # # # ### # # # # # ### # ### # # # # ### # # # # ### # # #
# # # # # # #   # #   # #     # # # # # # # # # # # # #   # # # # # # # # # # # #
# # # # # # # # ### # # # # # # ### # # # # # # # # # # # ### # # # # # # # # # #
# # # # # # # # # # # # # # #   # # # # # # # # #   # # # # #   # # # # # # # # #
# # # # # # # # # # # # # ### # # # ### # # # # ### # # # # # ### # # # # # # # #
# # #   # # # # # # # # # # # # # # # #   # # #   # # # #   # # # # # #   #   # #
### # # # ##### # # # ### # ### # # # # # # # # # # # # # # # # # # # # ##### # #
# # # # # # # # # # # # # # # # # # # # # # # # # # # # # # # # # # # # # #     #
# # # # # # # # # ### # # # # # # # # # # # # # # # # ### # ### # # ### # # # # #
# #   # # # # # # # # #   # #   # # # # # # # # # # # #   # # # #       # # # # #
# # ### # # # # # # # ### # # # # # # ### # # # ### # ### # # # ### # # # # # ###
#   # #   # # # # # #   # # # # # # # # # # # #   # # # # # # # # # # # # # # # #
# # # # # # # # # # # # # # # # # # # # # # # # # # # # ### # # # # # # # # # # #
# # #   # #   # #   # # # # # # # # # # # # # # # # #   # # # # # # # #   # # # #
# # # # # # # # # # # ### # # # # # # # # # # # # # # # # # # # # # # # # # # # #
# # # # # # # #   # # #   # # # #   # # # # # # # # # # # # # # # # # # #   # # #
# # # # # ### ### # # # ### # ### # # # # # # # ### # # # # # # # ##### # # # # #
# # # # #   # # # # # # # #     # # # # # # # # # #   # # # # # # # # # # # #   #
####### # # # # # # # ### # # # # # # # # # # # # ##### # # # # # # # # # # # # #
# # # # # # # # # # # # # # # # # # #   #   # # # #   # # # # # #     # # # # # #
# # # # # # # # # # # # # # # # # # # # # # # # # # # # # # # # # # # ### # # # #
# # # # # # #   # # # # # # # # # # # # # # # # # # #   # # # # # # #   # # # # #
# # # # # # # # ### # # # # # # # # # # # # # # # # # # # # # # # ### # # # # # #
#   # # # # # # # # # # # # # # # # # # # # # # #   # # # #     # # # # # # # # #
# # # # # # # # # # # # # # # # # # # # # # # # # # # # # # # # # # # # # # # # #
# # #   # # # # # # #   # # # # # # # # # #   # # # # # # # # # # # # # # # # # #
# # # # # # # # # # # # # # # ### # # # # ### # # # # # # ### # # # # # # # # # #
# # # # # #   # # # # # # # # #   # # # # # # # # # # # # # # # # # # # # # # # #
# # # ### # # # # # # # # # # # # # # # # # # # # # # # # # ### # # ### # # # # #
# # # # # # # # # # # # #   # # # # # #   # # #   # # #       # # # # # # # # # #
# # # # # ### # # # # # # # # # # # # # # # # # # ### # # # # # ### # # # # # # #
# #   #   # # # #   # #   # # # # # # # # # #   # #   # # # #             # # # #
# # ### # # ### # # # # # # # # # # # # # # # # # # # # # # # # ### # # # # # # #
# # #   # #       #   # # # # # # # # # # #   # # # # # # # # # #   # # # # # # #
########################### #####################################################

