########################################### #####################################
# # # # # # # # # # # # # # # # # # # # #   #   # # # #   # # # #   #   # # # # #
# # # # # # # # # # # # # # # # # # # # # # ### # # # # # # # # # # # # # # # # #
# # # # # # #   # # #   # # # # # # #   # # # # # # # # #   # # # #   # #   # # #
# # # # # # # # # # # # # # # # # # # # # # # # # # # # # # # # # # # # # # # # #
# # # # # # # # # #   #   # # # #   # # # # # # # # # # # # # #   # # # # #   # #
# # # # # # # ### # ### ### # # # # # # # # # # # # # # # # # # # # # # ### # # #
# #   #   # # # # # # # # # # # # # # #   # # # #   # # # # # # # # # # # # # # #
# # # # # # # # # ### # # # # # ### # # # ### # # # # # # # # # # ### # # # ### #
# # # # #   # # # # # # # # # # # # # # # # # # # # # # # # # # # # # # # # # # #
# ### # # # # # # # # # # # # # # # ##### # # # # # # ### # # ##### # # # # # # #
# # # # # # # # # # # # #   # # # # # # # # # # # # # # # # # # # # # #   # # # #
# # # # # # # # # # # # ### # # # # # # # # # # ### # # ### # # # # # # # # # # #
# #   # # #   # # # # # # #   # # # # # # # # #     # # # # # # # #   # # # # # #
# # # # ### # # # # # # # # ### # # # # # # # ##### # # # # # # # ### # # # # # #
# # # # # # # # # # #   # # # #     #   # # # # # # # # # #   # #   # # #   # # #
# # # # # # # # # # # # # # # # # # # # # # # # # # # # # # # # # # # # # # # # #
# # #   # # # # # # # #   # # # # #   # # # # # # # # # # # # # # # # # # #   # #
# # # # # # # # # # # ### # # ### # ### # # # # # # # # # # # # # # # # # # # # #
# # # # #   #     #   #   #   # # # # # # # # # # #   # # # # # # # # # # # # # #
# # # # # # # # # # ##### # # # ### # # # # # # # ### # # # # # ### # ### # # # #
# # # # # # # # # # # # # # #   # # # # # # # # # # # # # # # # # # # # # # # # #
# # ### # # ### # ### # # # # # # ### # # # # # # # # # # # # # # # # # # # # # #
# # # # # # # # # # # # #   # # # # # #   # # # # # # # # # # # # #   # # # # # #
# # # ### # # # # # # # # # # # # # # # # # # # # # # # # ### # # # ### ##### # #
#   #   # # # # # # #     # # #   # # # #     #   # # # # # #   # # # # # # #   #
# # # # # # # ### # # # # # # # # # # ### ### # # # # # # # # # # ### # # # # # #
# # # # # # # #       # # # # # # # # # # # # # # # # # # # # # # # # #   #   # #
# # # # # # # ### # # # ### # # # # # # # # # # # # # # # # # # # # # # # # # # #
# # # # # # # # # # # #   # # # # # #   #   # # # #   # # # # #   # # # #   # # #
# # # # # # # # # # # ### ### # # # # # # ### ### # # # # # # # # # # # # # # # #
# # # #   # #   # # # # # #   # # # # #   #   # # # # # # # # # # # # # # # # # #
# # # # # # # # # # # # ##### # # # # ### # # # # # ### # # # # # # # ### ### # #
# # # # # # # # # # # # # # # # # #   # # # #   # # # # # # # # # # # #     # # #
# # # # # ### # # # # # # # # # # # # # # ### # # # # # # # ### # # # # # ### # #
# # # # # # # # # # # # # #   # #   # # # # # # #   # # # # # # # # # # # # # # #
# # # ### # # # # # # # # # # # # # # # # # # # # # # # # # # ### # # # ### # # #
# # #   # # # #   # # # # # # # # # # # # # # # # # # # # # #   # # # # # # # # #
# # # # # # # # # # ### # # # # # # # # # # # # # # # # # # # # # # # # # # # # #
# # # # # # # # # # #   # # # # # # # # #   # #   #   # # #   # #   # # # # # # #
### # # # # # # # # # # # # # # # ### # # # # # # # # # # # # # ### # ### # # # #
# # # # # #   # # # # #     # # # # # # # # # # # # # # # # # # # # # # # #   # #
# # # # # # # # # # # # # # # ##### # # # # # # ##### # # # # # # # # # # # # # #
# # # # # # # # # # # # # # # # #     #   # # # # # # # # # # # # #   # # # # # #
# # # # ### # # # # # # # # # # # # # ### # # # # # # # # # # # # # # # # # # # #
# # # # # # # # # # # # # # # # # # # # # # # # # # # # #   # # # # # # # # # # #
# # # # # # # # # # # # # # # # # # # # # # # # # # # # # ##### # # # # # # # # #
#   # # # # # # # # # # # # # #   # # # # # # # # # # # # # # #     # # #   # # #
# # # # # # # # # # # # ### # # # # # # # ### # # # # # # # # # # # # # # # # # #
# # # # # # # # # # # # # # # # # # # # #   # # # # # # # # #   # # # # # # # # #
# # ### # # ### # # # # # # # # # # # # # # # # # # # # # # # # # # # # # # # # #
# # #   #   # # # # # # #   # # # # # # # # # # # #   # # # # # # # # # # # # # #
# # # # # # # ### # # # # # # # # # # # # # # ### # # # ### ### # # # # # # # # #
# # # # # # #     # # # # # # # # # # #   # # #     #           # # #     # # # #
# # # # # # # # # # # # # # # # # # # # # ### # # # # # # # # # # # # # # # # # #
# # # # # # # # # # # # # # # # # # # # # #   # # # # # # # # # # # # # # # # # #
############################################# ###################################

