##### ###########################################################################
# # # # # # # # # # # # # # # # #   # # # # # #   # # # #   # # #   # # # # # # #
# # # # # # # # # # # # # # # # # # # # # # # ### # # # # ### # # ### # # # # # #
# #   #     # # # # # # # # # #   # # # # #   # # # # # #   # #     # # # # #   #
# # # ### # # # # # # # # # # # # # # # # # # # # # # # # # # ### # # # # # # # #
# # # # # # #   # # # # # # # # # # # # # # #   # # #   # # #   # #   #   # # # #
# ### # # # ### # # # # # # # # # # # # # # # # # # # # # # # # ### # # # # ### #
#   # # # # # # # # # # # #   # # # # # # # # #   # # # # # # #   # # # # # # # #
# # # # # # # # # # # # # ### ### # # # # # # # # # ### # # # # # ### # # # # # #
# # # # # #   # # # # # # #   # # # # # #   # # # # # # # # # # # # # # # # # # #
# # # # ### # # # # # # # # # # # # # # ### # # # # # # # # # # # # # # # # # # #
# #   # # # # # # # # # # # # #   #   # #   # # # # # # # # # # # # #   #     # #
### # # # # # # # # # # # # # ### # # # ##### # # # # # # ##### # # # # ### ### #
# # # # # # # # # # # # # # # # # # # # # # # # #   # # #   # # # # # # # # # # #
# # # # # # # # # # # # # ### # # # # # # # # ### # # # ### # # # # # # # # # # #
# # # #   # # # # # # # # # # # # # #   # # # # # # #   # # # # #   # # # # # # #
# ### ### # # # # # # # # # # # # # # # # # ### # # ### # # # # # # ### # # # # #
# # # # # # # # #   # # #     # # # # # # # # #   # #   # # # # # # # # # # # # #
# # # # # # # # # # # # # # # # # # # # # # # # # # # # # # # # # ### # # # # # #
# # # # # # # #   #   # # # # # # # # #     #   # # # # # # #   # # # # # # # # #
# # # # # # # # # # ### # # # # # ####### # # # ### # # # # # # # # # # # # # # #
# # # # # # # # # #       # # # # # # # # #   # # # # # # # # # # # # # # #   # #
# # # # # # # # # # # # # # # # # # # # # # # ### # # # # # # # # # # # # # # # #
# #     # # #   # # # # # # # # # #   # # # # # # # # # # # # # # # # # # # # # #
# # # # # # # # # # # # # ### # ### # # # # # # # # ### # # # # # # # # # # # # #
# # # #   # # # # # # # # # # # # # #   # # # # # # # # #   # # # # # # # # # # #
# # # # # # # # # ### ### # # # # # # # ### # # # # # # # # # ### # # ### # # # #
# # # # # # # # # # # #   # # # #   # # # # # # # # # # # # # # # # # # # # # # #
# # ### # # # # ### # # ### # # # # # # # # # # # # # # # # # # # # # # # # # # #
# # # # #   # # # # # #   #       # # # # # # # # # # # # # # #     # # #   #   #
# # # # ### # # # # # # # # # # ### # # # # # # # # # # # # ### # # # # # # ### #
# # # # # # # # #   # # # # # # # # # # # # # # # #   # # # # # # # # # # # # # #
# # # # # # # ##### # ### # # ### ##### # ### # # # # # ### # # # # # # # # # # #
# # # # # # #   # #   # # # # #   # # #       # # # # # # # # # # # # # # # # # #
# # # # # # # # # # ### ### # ### # # # # # ### # # # # # # # # # # # # # ### # #
# # # # #   # # # # # # # # # # #   #   # # # # # # #     # #   # #   # # # # # #
# # # # # ### # # # # # # # ### # # ### # # # # # # # # # # # # # # # # # # # # #
# # # # # # # # #   # # # #     # # # # # # # #   # # # # # # # # # # # # #   # #
# # # # # # # # # # # # # ### # # # # ### # # # # ### ### # # # # # # # # # # # #
# # # # # # # # # #   #   #   # # # # # # # # # # # # # # #   # # # # # # # # # #
# # # ### # # # # # # # # # # # # # # # # # # # # # # # # # # ### # # # ##### # #
# # # # #   # # # # # # #   # # # # # # # # # # # # # # # # # # # # # # # # # # #
# ### # # # # ### # # # # # # # # # # # # # # # # # # # # # # # # # # # # # # # #
# # # # # # # # # # # # # # # # # # #   # # # # #   # # # # # #   # # # # # #   #
# # # # # # ### # # # # ### # # ### # # # # # # # # ### # # # # # # # # # # ### #
# # # # # #   # # # # # #   # # # # # # # # #   # # # #     # # # # # # # # # # #
# # # # # ### # # # # # # # # ### # # # # # # # # # # ### # # # # # # # # # # # #
# # # # #   # # # # # # # # # #   # # #   # # # # # # # # # # # # # # # # # # # #
# # # # # # # # # ### # # # # ### # # # # # # # # # # # # # # # # # # # # # # # #
#       # # # # # # # # # # # # # #   # # # # # # #   # # # # # # # # # # # # # #
# # # # # # # # # # ### # # # # # # # # # ### # # # # # # # # # # # # # # # # # #
# # # #   # # # # #   # # # # #   # # # # # # # # # #     # # # # # # # # # # # #
# # # # # # # # ### # # # # # # # # ### # # # # # # # # # # # # # # # # # # # # #
# # # # # # # #   # #   # # # # # # # # # # # # # # # # # # # # # # #           #
# # # # # # # # # # # # # # # # # # # # # # # # # # # # # # # # # # # # ### # # #
# # # # # # # # #   # # # # # # #     # #   # # # # # # # # # # # # # #   # # # #
############### #################################################################

