########################################################################### #####
# # # # # # # # # # # # # # # # # # #   # # # # # # # # # # # # # #   # #   # # #
# # # # # # # # # # # # # # # # # # # # # # # # # # # # # # # # # # # # # # # # #
# # # # # # # # # # # #   # # # #   # #   # # #     # # # # #   # # #   # # # # #
# # # # # # # # # # # ### # # # # # ### # # # # # # # # # # # # # # # # # ### # #
# # # # #   # # #   # # # # # # # #     # # # # # #   # # # # # # # # # # # # # #
# # # # # # # # ### # # # # # # ### # ### # # # ##### # # # ### # ##### # # # # #
# # #   # # # # # # # # # # # # # # # # # #     # # # # # #     #   # # # # # # #
# # # # ### # # # # # # # # # # # # # # # # # # # # # # # # ### ### # # # # # # #
#   # # # # # # # #   # # # # # # # # # # # # # # # # # # # # # # # # #   # #   #
# # # # # # # # # # # # # # # # # # # # # # # ### # # # # # # # # # # # # # # # #
# # # # # # # #   # # # # # #   # # # # # # # # #   # # # # # # # # # # # # # # #
# # ### # # # # ### # # # # # ### # # # # # ### # ### # # # # # # # # # ### # # #
# # # # # # #     # # # # #   #   # # # # # # #   # # # # # # # # # # #   #   # #
# # # # # # ### # # # # # # # ### ##### # # # ### # # # # ### # # # # # # # # # #
# # # # #   # # #   #   # # # # # # # # # # # # # # # # # # # # # # # # # # # # #
# # # # ### # ### # # # # # # # # # # # # ### # # # # # # # # # # # # # # # # ###
# #       # # # # # # # # # # # # # # # # # # # # # # # # # # # #   # # # # # # #
# # ### ### # # # # # # # # # # # # # # # # # # # # # # # # # # # # # ### # # # #
# # # # # # # # # # # # # # # # # # #     # # # # # # # # #   #   # # # # # # # #
# # # # # # # # # # ### # ### # # # # # # # # # # # # # # # # # # # # # # # # # #
# # # #   # # # # # # # # #   # # # # # # # # # # # #   # # # # # # #     # # # #
# ### ### # # # # # # # # # # # # # # ### # # # # # # # # # ### # # ### # ### # #
# # # #   #   # # # #     # # # #     # #   #     # # # #   # # # # # # # # # # #
### # # # # # # # # # # # # # # # # ### ### # # # # # # # # # # ### # # # # # # #
# # # # # # # # # # # # # # # # # # # # #     # #   # # # # # # # # # # # # # # #
# # # ### ### # # # # # # # # # ### # # ### # # # # ### # # # # # # # ### # # # #
#   # # # #     # # # # # # # # # # # # # # # # # # # # # # # # # # #   # # #   #
# # # # # # # # # ##### # # # # # # # # # # # # # # # # ### # # # # # # # # # # #
# # # #   # # #   # # # # # # # # # # # # # # # # # # # # # # # #   # # #   # # #
# # # ### ### # # # # # # # # # # # # # # # ##### # # # # # # ### # ### # # # ###
# #   #   # # # # # # # #   #   #   #   # # # #   # #     # # # # # #   # #   # #
# # # # # # # # # # # # # # # # # # # # # # # # # # # # ### # # ### ### ### # # #
# # #   # # # # # # #   # # # # # # # # # # # # # # # # #   # # # # #     # # # #
# # # # # # # ### # # # # # ### # # # # # # # # # # # # # # # # # # # # # ### # #
# # # # # # # # # # # # # # # #   # # # # # #   # # # # # # # # # # # # # # # # #
# # # ### # # # # # # # # # # # # # ### # # # # ### # # # # # # # # # # # # # # #
# # # # # # # # # # # # # # # # # # # # # # # # # # # # # # # # # # # # #   # # #
# # # # # # # # # # # # # # # # ### # # # # # # # # # # # # # # # # # ### # # # #
# # # # # # # #   #   # # # # # # # # # # # # # # # # # # # #   # #     # #   # #
# # # # # # # # ### # # # # # ### # # # # # # # # # # # # ### ### # # # # ### # #
# # # # #     # # # # # # # # # #   # # # # # # # # # # # # # # #   # # # # #   #
# # # # # # # # # # # ##### # # # # # # # # # # # # # # # # # # # # # # ### # # #
# # # # # # # # # # # # #   # # # # # #   # # # # #   # # #     # # # # # #   # #
# # # # ### # # # # ### ### # # # ### # # # # # # # ### # # # # # # # # # # # # #
# # # # # # # # # # # # # # # #   #   # #   # # # # # #   # # # # # # # # # # # #
### # # # # # # # # # # # # # # # # # # # # # # # # # # # # ### # # # # # # # # #
# # # #   # # # # # # #   # #   # # #   # # # # # # # # # # # # # # # # # # # # #
# # # # # # # # # # # # # ### ### # # # # # # ### # # ### ### # # # # # # # # # #
# # # # # # # # # # # # # # #   # # # # # # # # #   # # # # # # # # # # #   # # #
# # # # # # # # # ### # # # # # # # # # ### # # # # # # # # # # ### # # # # # # #
# # # # # # # # # # # # # # # # # # # # #   # # # # #               # # # # # # #
# # # # # # # # # # # # # # # # # # # # # # ### # # # # # # # # # # # # # # # # #
# # # # # # # # #   # # #   # # # # # # # #   #   # # # # # # # # # # # # # # # #
# # # # # # # # # # # # # # # # # # # # # # # # # # # # # # # # # # # # # # # # #
#   # # #   # # # #     # #   # # # # # # # # # # # # # # # # # # # # # # # # # #
################################# ###############################################

