########################### #####################################################
#                                                           #             #     #
####################################### ####### ########### # ########### # # ###
#                               # # # # #     #       #   # # # #   #   # # #   #
################### ########### # # # # ##### # ##### # # # # # ### # # # # # ###
#                             # # # # #     # # #   # # # # # #   # # # # # #   #
############################### # # # ### # # # # # # ### # # # # # # # # # # ###
#                           #   # # #     # # # # # # # # # #   # # # # # # #   #
########################### # # # # ##### # # # # # # # # # ##### # # # # # #####
#                         # # # # #       # # # # # # # # #       # # # # # # # #
######################### # # # # ######### # ##### # # # ######### # # ### # # #
#                       # # # # #           # # # # #               # # # #     #
# ### ############### # # # # # ########### # # # # # ############### # # # # ###
# #         #         # # # # #             # # # # #                 # # # #   #
# ################### # # # # ############# # # # # ### ############### # ### # #
# # #               # # # # #           #   # # #                     # #     # #
# # # ############# ### # # ################# # # ######### ############# ### # #
# # # #           # #                         #   #       # #             #   # #
# # # ########### # ########################### ### ##### # ##### ### ### ### # #
# # # # # # # # # #                           #     #     # #   #   # #     # # #
# # # # # # # # # ####################### ### # # ### ### ### ############### ###
# # # # # # # #                         # # # # # #   # # # # #                 #
# # # # # # # ####################### # # # # # # ##### # # # # ######### #######
# # # #     #                     # # # # #   # # # # #   # # #   #             #
# # # # ### ######### ############# # # # ##### # # # ### # # # #################
# # # #   #                       # # #         # #         # # #               #
# # # # # ##################### ### ### ############# ##### # # # ############# #
# # # # # #                   #   # #               #   #   # # # #           # #
# # ### ##################### # ### # # ######### # ######### # # # ######### ###
# # # #     #                 #   # # #         # # #       # # # # #       # # #
# # # # # ################### # # # # # ####### # # # ##### # # # # # ##### # # #
# # # # # #                   # # # # #       # # # # #   #   # # # # #     # # #
# # # # ### ################# # ### # # ####### # ### ### # # # # # # # ### # # #
# # # # # # #               # # # # # # #   # # # # # # #   # # # # # # #     # #
# # # # # # # ####### ####### # # # # # # # # # # # # # # # # # # # ### ####### #
# # # #   # # #           # # # # # # # # # # # # # # #   # # # # # # #         #
# # # ### # # # ######### # # # # # # # ### # # # # ######### # # # # ###########
# # # # # # # # #       # #   # # # # #     # # # # #           #   #           #
# # # # # ############# # # # # # # # ####### # # # # ########### ############# #
# # # # # #       #   #   # # #   # #         # # #     #                     # #
# # # # # # ##### ### # # # # # ### ######### # ####### # ### # # ########### # #
# # # # # # #   #   # # # # # # #             #       # #   # # #       #   # # #
# # # # # # # # ### # # # # # # # ################### # # # # ### ####### # # # #
# # # #   # # #   # # # # # # # # #                 # # # # # # #       # # # # #
# # # # # # # # ### # ### # # # # # ############### # # ### # # ####### # # # # #
# # # # # # # #     # # # # # # # # #             # # #     # # #     # # # # # #
# # # # # # # ####### # # # # # ### # ######### # # # # ##### # # ### # # ### # #
# # # # # # #           # # #   # # # #     # # # # # # #     # # #     # # # # #
# # # # # # ############# # ### # # ### ##### # # # # # ####### # ####### # # # #
# # # # # #                 #   # # # # #     # # #   #         #           # # #
# # # # # ##################### # # # # ### # # # # ######################### # #
# # # # #                   #   # # # #   # # # # #                           # #
# # # ######### ################# # # # ### # # # ############### ############# #
# # #                             # #       # # #                               #
# # ######### ##################### ##### # # # ############################### #
#                                         # # #                             #   #
################### #############################################################

