############################################### #################################
# # # #                           #                             #               #
# # # ######### ####### ##################### # # ########################### # #
# # #   #     # #     # #                   # # # #               #           # #
# # # ### ### # # ##### # ################# # # ### ######### ### # # ####### # #
# # #   # # # # # #   # # # #             # # # # #         # #   # # # #   # # #
# # ### # # # # # # ### # # # # ######### # ### # # # ### ### # ##### # # # # # #
# #   # #   #     # # # # # # # #       # # # # #   # # # # # #     # # # # # # #
# # # # # ######### # # # # ### # # ##### # # # # ### # ### # ####### # # # # # #
# # #   #           # # # # # #   # #   # # # # # # # #     #         # # # # # #
# ##### ############# # # # # # ### # ### # # # # # # # ### # ##### ### # # # # #
# #     #   #         # # # # # # # #       # # # # # #   # #     #     # # # # #
# # ### ### ### # ### # # # # # # # ######### # # # # ### ############### ### # #
# #   #         #   #   #   # # # #               # #                     # # # #
# ################# ######### # # ################# ### ################### # # #
#                                               #             # #           # # #
############################################### ############# # # ########### # #
#                                     #       # # # #         # # #       #   # #
# ########################################### # # # ####### ### # # ######### # #
# # #                                         # #   #     # # # # # #       # # #
# # # ####################################### # ### # ##### # # # # # ##### # # #
# # # #                                     # #     # #     # # # # # #     # # #
# # # # ################################### # # # # # # ### # # # # # # # # # # #
# # # # #     #                           # # # # # # # #   # # # # # # # # # # #
# # # # # ########### ################### # # # # # # # ##### # # # # # ##### # #
# # # # # #                       #     # # # # # #   #           # # #       # #
# # # # # # ########################### # # # # # # ### ########### # ###########
# # # # #   #           #             # # # # # # # #           #   #         # #
# # # # # # # ####################### # # # # # # ### ############# ########### #
# # # # # # # #                       # # # # # # # # #               #       # #
# # # # ### # # # ################### # # # # # # # # # # ############# ##### # #
# # # # #   # # # #                 # # # # # # #   # # # # #             # # # #
# # # # # # # # # # ############### # # # # # # ### # # ### # ####### ##### # # #
# # # #   # # # # # #             # # # # # # # #   # #     # #       #   # # # #
# # # # # # # # # # # ########### # # # # # # # # # # ##### # # # # ### ### # # #
# #   # # # # # # # # #           # # # # # # # # # #       # # # #   # #     # #
# ########### # # # # # ######### # ### ### # # # # ######### # # ### # # ### # #
#   #           # # # # # #     # # # # # # # # # # #         # #   # # #   # # #
# ############# # # # # # # ##### # # # # # # # # # # ######### ##### # ### # # #
#             # # # # # # # #   # # # # # # # # # # # # #         #   #   # # # #
# ####### ### # ### # # # # ### # # # # # # # # # ### # # # ########### ### # # #
# #         # # # # # # # #   #   # # # # # # # #   # # # # #             # # # #
# # ####### # # # ### # # ### ##### # # # # # # ##### # # # # ############# # # #
# # #     # # # # # # # #   #       # # # # # #     #   # # # # #           # # #
# # # ### # # # # # # # ### # ####### # # # # # ####### # # # # ############# # #
# # # # # # # # # # # #   #             # # # #         # #     #             # #
# # ### # # # # # # # # ########### ##### # # # # ######### ### # ########### # #
# # # #     # # # # # #             #       # # # #           # # #         # # #
# ### ####### # # # # # ############# ####### # # # ######### ### # ####### # # #
#   #         # # # # #                       # # # #       # #   # #     # # # #
# # ########### # # # ######################### # # # ##### ######### ### # # # #
# #             # # #                           # # # #     #       # #     #   #
# ### ##### ### # # ####################### # # # # # # ### # ####### ####### # #
# #   #       # # #                         # # # # # # # # #                 # #
# ############### ########################### # # # # # # # ################### #
#                                             # # #   # #                     # #
########### #####################################################################

