########### #####################################################################
# #                                                             #               #
# ############################################# ############################### #
# #                     #                                     #               # #
# ########### ########################### ################################# # # #
# # #                             #       # # #         #                   #   #
# # # ##### ######### ### ############### # # # ########################### # # #
# #   #     # #     # # # #               # # # #                         # # # #
# ######### # # ### # # # # ############# # # # # ####################### # # # #
# #         #     # # # # # #           # # # # #   # #   #             #   # # #
# ######### # ####### # # # # ######### # # # # # # # ### ##### # ####### # ### #
# #       # #       # # # # # #         # # # # # # # #   #   # #       # # # # #
# ####### # # # # # # # # # # ####### ### # # # # ### # # # # ######### # # # # #
#         # # # # # # # # # # # #   # # # # # # # # # # #   #         # # # # # #
######### # # # # ### # ### # # # ### # # # # # # # # # ####### ##### # # # # # #
#       # # # # #       # # # # #           # # # # # #     # #     # # # # # # #
# ##### # # # # ######### # # # # ####### ### # # # # ####### # ####### # # # # #
# #   # # # # #           # # # #       #     # # # #         #         # # # # #
# # # # # # # # ########### # # ############### # # ######### # # ##### # # # # #
# # # # # # # # #         # # #                   # #       # # # #   #   # # # #
# # ### # # # ########### # # ########### ######### ####### # # ### # # # # # # #
# #       # #           # # #                       #     # # # # # # # # # # # #
# ######### ############# # ######################### ### # # # # ### # # # # # #
# #               #       #   #   #   #   #           #   # # # #     # # #   # #
# # ############### ############# # # ### # ##### ### # # # # # ##### ### # # # #
# #                             # # #   # # # #   #   # #   #       #   # # # # #
# # ########################### # # # ### # # # # # # # ### ##### ### # # # # # #
# #       #                   # # # #       # # # # # #   # #     #   #   # # # #
# # ######################### # # ### ##### # ### ### ########### # # # ### ### #
# # #                       # # # # # #     #     #               # # #   # # # #
# # # ################### # # # # # ########### ####################### # # # # #
# # # #                 # # # # # #                               #     # # # # #
# # # # ############### # # # # # # ### ################################### # # #
# # # # #             # # # # # # # # # #                                   # # #
# # # # # ########### # # # # # # # # # # ################################### # #
# # # # # #         # # # # # # # # #   # #                                   # #
# # # # # ######### # # # # # # # # ### # # ########################### ##### ###
# # # # # #       # # # # # # # # #   # #   #                               # # #
# # # # # # # ### # # # # # # # # # # ##### # ############# ############### # # #
# # # #   # #   # # # # # # # # # # # # # # #           #                 # # # #
# # # ### ##### # # # # # # # # # # # # # # # # ######################### # # # #
# # # # # #     # # # # # # # # # # # # # # # # #                       # # # # #
# # # # # ####### # # # # # # # # # # # # # # # # ##################### # # # # #
# # #             # # # # #   # # # # # # # # # # #                   # # # # # #
# # ############### # # # # # # # # # # # # # # # # ################# # # ### # #
#                   # # # # # # # # # # # # # # # # #           #   # # # # # # #
# ################### # # # # # # # ### # # # # # # # ############# # # # # ### #
# #                   # # # # # # #     # # # # # # #         #   # # # # #     #
# # ################### ### # # # ####### # # # # # ### ######### # # # # ##### #
# # #     #             # # # # #         # # # # # # #       # # # # #         #
# # # ### ############### # # # ####### ### # # # # # ### # # # # # ########### #
# # # #                   # # # #           # # #         # # # # #             #
# # # # ################# # # # ### ######### # ########### # # # ###############
# # # #   #               # #               # #       #     # # #               #
# # # ##################### ################################# # # ############# #
# # #                                       #                       #           #
####################### #########################################################

