### #############################################################################
#                                               #     #                         #
# ########################### ### ############# # ### ######################### #
# #                             # #             #   # #                       # #
# ############### ############# # # ############### # ####################### # #
# #                           # # #               # # # #                     # #
# ########################### # # # ############# # # # # ################### # #
# #                       # # # # # #   #       # # #   # #                 # # #
# # ##################### # # # # # # ######### # # # # # # ######### # ### # # #
# # #             #         # # # # # #       # # # # # # # #       # # #     # #
### # ####################### # # # # # ##### # # # # ### # # ### ### # ####### #
# # #                       # # # # # # #   # # # # # # # # # # #     #       # #
# # # ####################### # # # # # # # # # # # # # ### # # ############# # #
# # # #                       # # # # # # # # # # # # #     #               #   #
# # # # ####################### # # # # # ### # # # # # ################### # # #
# # # # #                     # # # # # #       #   # # #   #             # # # #
# # # # # ##################### # # # # ######### ### # # # # ########### # # # #
# # # # #                       # # # #             # #   # # #           # # # #
# # # # # ####################### # # ### ########### # ### ############# # # # #
# #   # # #                       # #             #   # #   #           # # # # #
# # # # # # ####################### ################### # ############# # # # ###
# # # # # # #   #                     #                 # # #       # # # # # # #
# # # # # # # ################################# ######### # ### ##### # # # # # #
# # # # # # # #                               # #         # # #     # # # # # # #
# # ### # # # # ############################# # # ### ##### # # ### # # # # # # #
# # # # # # # #                             # # # #         # # #   # # #   # # #
# # # # # # # # ########################### # # # # ####### # # # ### # # # # # #
# #   # # # # #                           # # # # # # #   # # # #     # # # #   #
# # # # # # # # ######################### ### # # # # ### # # # ####### # # # # #
# # # # # # # #                         # # # # # # #   # # # #           # # # #
# # # # # # # ########################### # # # # ### # # ### ############# ### #
# # # # # # # #                       # # # #   # # # #     #               #   #
# # # # # # # # ############### # # ### # # # # # # ### # # # ############### # #
# # #   # # # # #             # # #   # # # # # # # #   # # # #       #       # #
# ### # # # # # # ########### # # # # # # # # # # # ##### # # # ##### # ### ### #
# #   # # # # # #           # # # # # # # # # # # #       # # #     # #   #   # #
# # # # ##### # # ######### # # # ### # # # # # # ######### # # ### # # ##### # #
# # # # # # # # # #   #   # # # # # # # # # # # # #         # #   # # # #   # # #
# # # # # # # # # # ##### # # # # # # # # # # # # # ####### # ### # # # # ### # #
# # # # # # # # # # #   # # # # # # # # # # # # # #       #       # # # # # # # #
# # # # # # # # # # ### # # # # # # # # # # # # ### ##### ####### # ### # # # # #
# # # # # # #   #       # # # # # # # # # # # # # #     # #       # # #     # # #
# # # # # # # # ######### # # # # # # # # # ### # # ### ########### # ####### # #
# # # #   # # #           # # # # # # # # # # # # # # # # #         # #       # #
# # ### # # ############### # # # # # # # # # # # # # # # ########### # # ##### #
#   # # # #                 # # # # # # # # # # # # #     #           # # #   # #
# # # # # ################### # # # # # # # # # # # ####### ########### # # # # #
# # # # #                     # # # # # # # # # # #         # #         # # # # #
# # # # ########### ########### # # # # # # # # # ########### ########### ### # #
# # # #           #     #       # # # # # # # #   #                           # #
# # # ##### ##################### # # # # # # # ############################### #
# # #                             # # # #   #                                 # #
# # ############################### # # ##### ################################# #
# #                                 # #                                       # #
# ################################### # ####################################### #
#     #                                       #                                 #
############################### #################################################

