############################# ###################################################
#             #                                     # # # # #   #               #
# # ########### ################################# ### # # # # # # ######### # ###
# #       #   # # # #                           #   # # # # # #   #       # # # #
# ########### # # # ### ####### ### ########### # ### # # # ####### ##### # ### #
#             # # #         #   #         #     #       # # #       #   # #     #
# # ######### # # ############# # ############# ######### # ####### # ### # #####
# # #       # #     #           # #           #           #       # #     #   # #
# # # # ### # # # ############### # ######### ################### # ######### # #
# # # #   # # # # #           # #   # #             #             # #         # #
# # ### ### # # ### # ####### # # # # # ########### ##### ####### # # # ####### #
# # #   # # # # # # # #     # # # # #   #     #             #     #   #         #
# ### # # # # # # # # # ### # # # # # ### ### # ############# ### ### ##### # ###
#   # # #   # # # # # # #     # # # #   # #             #     # # #     #   # # #
# # # # ##### # # # # # ####### # # ### # ##################### # ########### # #
# # # #       # # # # #           #   # #             #                         #
# # # ######### # # # ################# ################################# ##### #
# # #           # # #         #             #   #                             # #
### ############# # ######################### ##### ######################### ###
# #           #   #         # #                                             # # #
# # # ######### # # ####### # # ########### ##### ######################### # # #
# # #     #     # #       # # # #               # #                       # # # #
# # ####### ##### # ####### # # # # ### ########### ##################### # # # #
# #         #             # # # # # #     #   # # # #                   # # # # #
# ######### # ####### # ### # # # # # ####### # # # # # # ############# # # # # #
# #       # # #     # # # # # # # # # #     # # #   # # #         #   # # # # # #
# ####### # # # ### # ### # # # # # # # ### # # # # # # # # ######### # # ### # #
# #       # # # #   # # # # # # # # # # #     # # # # # # # #       # # # # # # #
# # ##### # # # # ### # # # # # # # ### ####### # # # # # ### # ### # # ### # # #
# # #   # # # # #       # # # # # # # #         # # # # # # # # #   # # # # # # #
# # # ### # # # ######### # # # # # # ##### ##### # # # # # # # # ### # # # ### #
# # #     # # #           # # # # # #             # # # # # # # #     # # # # # #
# # # ##### # # ########### # # # # ############### # # # # # # # ##### # # # # #
# # #       # #           # # # # #                 # # # # # # #       # # # # #
# # # ####### ########### # # # # ################### # # # # # ######### # # # #
#   #       #   #         # # # #                   # # # # # #             # # #
# ######### # ######### ##### # ################### # # # # # ############### # #
# # #     # # #             # #                   # # # # # #                 # #
# # ##### # # # ########### # ####################### # # # # ################# #
# # #     # # # #         # #                       # # # # #                   #
# # # ### # # # # # ### # # # ##################### # # # # #####################
# #   #   # # # # # #   # # # #   #               # # # # #                     #
### ### ### # # ### # ### ### ### # ############### # # # ######### #############
# # # #     # # # # #   # # # # # # # # # #           # #                     # #
# # # ####### # # # ####### # # # # # # # # # ### # # # ##################### # #
# # #       # # #               # # # # # # # # # # # #                     # # #
# # ##### # # # # ############### # # # # # # # # # # # ##################### # #
# #       # # # #                   # # #   #   # # # #             #       # # #
# # ####### # # # ################### # ### ### # ### # ################# ### # #
#         # # # #                     # #   # # # # # #                     # # #
# ####### # # # ####################### ### # # # # # ####################### # #
# #   # # # # #                         # # # # # # #                 #     # # #
# # ### # # # ######################### # # # # ### ##### ################# # # #
# # #   # # #                     #         #   # # #                       # # #
### # ##### ##################################### # ######################### # #
#                                                                           #   #
################################################################### #############

