################################################### #############################
#               #                 #   #                                         #
# ############# ### # ########### # # # ########### ############### ########### #
# #       #       # # #       # #   #   #         # # # #                     # #
# ##### ######### ### ### ##### # ### # # ####### # # # # ################### # #
# # # # #           #         #     # # # #       # # # # #                 # # #
# # # # # ######### # # ################# # ##### # # # # # # ########### ### # #
# # # # # #       # # #                   #     # # # # # # # #           # # # #
# # # # # ### # # # # # ####################### ##### # ### # # ######### # # # #
# # # #       # # # # #     #                 #   # # # # # # # #       # # # # #
# # # ######### # # # ### ################### ### # # # # # # # ####### # # ### #
# # #           # # #   # #                     # # # # # # # #       # # # # # #
### ############# # # # # # ################### # # # # # # # ####### # # # # # #
# #               # # # # # #     #           # # # # # # # # #     # # # # # # #
# # ############### # # # # # ############### # # # # # # # ##### ### # # # # # #
# # #         #     # # # # # #           # # # # # # # # # #       # # # # # # #
# # # ##### ####### # # # # # # ######### # # # # # # # # # ####### # # # # # # #
# # # #         # # # # # # # # #       # # # # # # # # # #       # # # # # # # #
# # # # # ####### # # # # # # # # ##### # # # # # # # # # ####### # # # # # # # #
# # # # #       # # # # # # # # # #   # # # #   # # # # #       # # # # # # # # #
# # # # ####### # # # # # # # # # ### # # # ### # # # # ####### # # # # # # # # #
# # # # #     #   # # # # # # #       # # # #   # # # #         # # # # # # # # #
# # # # # ### # ### # # # # # ######### # # # # # # # # ####### # # # # # # # # #
# # # # # #   # # # # # # # #           # # # # # #   # #     # # # # # # # # # #
# # # # # ### # # # # # # # ########### # # # # # # # # # # ### # # # # # # # # #
# # # # #   #   # # # # # #     #       # # # # # # # # # #     # # # # # # # # #
# # # # ######### # # # # ### # # ####### # # # # # ### # ####### # ### # # # # #
# # # #           # # # #   # # # # #     # # # # # # # #   # #       # # # # # #
# # # # # ##### # # # # ### # # # # ####### # # # # # # # # # # ####### # # # # #
# # # # # # #   # # # #   # # # # #   #     # # # #   # # # # # #   #       # # #
# # # # ### ##### # # # ### # # # ### # ##### # # # # # # # # # # ######### # # #
# # # #         # # # #   # # #   #           # # # # # # # # # # #       # # # #
# # # ########### # # ##### # ################# # # # # # # # # # ### ##### # # #
# # # #     #     # # # # # #       #             # # # # # # # # #       # # # #
# # # # # ####### # # # # ### ##################### # # # # # # # # ##### # # # #
# # # # #         # # # # # #                       # # # # # # # # #   # # # # #
# # # # # ######### # # # # # ####################### # ### # # # # # ### # # # #
# # # # # #         # # # # #                     #   # # # # # # #   #   # # # #
# # # # # # ####### # # # # ########################### # # # # # # ##### # # # #
# # # # # # #     # # # # #                             # #   # # # #   # # # # #
# # # # # # # # # # # # # ############################### # # # # # ### # # # # #
# # # # # # # # # # # # #                         #         # # # #   # # # # # #
# # # # # # ### # # # # # ##### ############# ############### # # # ### ### # # #
# # # # # #     # # # # # #     #   #                         #   #     # # # # #
# # # # ####### # # # # # # ### # # ############################### ### # # # # #
# # # #         # # # # # # #   # # #                               #   # # # # #
# # # ########### # # # # # ##### # # ################### ############# # # # # #
# # #     #       # # # # # #     # # #                 #   # #   #     # # # # #
# ################# # # # # ####### # # ################# # # # ######### # # # #
#       #           # # # #         # # #                 #               # # # #
# ##### # ########### # # ########### # ##### ####### ##################### # # #
# # # # #           #                 #       #                             # # #
# # # # # ######### ################# ####################################### # #
#   # #       #                                                             # # #
### # ####################################################################### # #
#                                                                             # #
############################################### #################################

