######################################################### #######################
#                           #                                       #           #
# ############################### ################################### ####### # #
# # #                                               #             # # #     # # #
# # # ############################# ############# ####### ####### # # # ### # # #
# # # #     #                               #                 # # # # #   # # # #
# # # # # # # ############################################# # # # # # ### # # # #
# # # # # #   #                                           # #   # # #     # # # #
# # # ### # ### ######################################### # ### # # ####### # # #
# # # # # # # # #                                       # # # # # #         # # #
# # # # # # # # # ##################################### # # # # # ########### # #
# # # # # #   # # #   #                   #           # # # # # #             # #
# # # # # # ### # # ################### ############# # # # # # ############### #
# # # # # #   # # # #                                 # # # #         #       # #
# # # # # # # # # # # # ############################# ### # # ############### # #
# # # # # # # # # # # # #                           # # # # #               # # #
# # # # # # ### # # # # # # ####################### # # # ################### # #
# # # # # # # # # # # # # #                       # # # #                   # # #
# # # # # # # # # # # # # # ##################### # # # ################### # # #
# # # # # # #   # # # # # # #                   # # # #                   # # # #
# # # # # # # # # # # # # # # ################# # # # ################### # # # #
# # # #   # # # # # # # # # # #                 # # # #             #   # # # # #
# # # # # # # # # # # # # # # # # # ##### ##### # # # # ########### ### # # # # #
# # # # # # # # # # # # # # # # # # #         # # # # # #   #     #     # # # # #
# # # # # # # # # # # # # # # # # # # ####### # # # # # # ### # # ##### # # # # #
# # # # # #   # # # # # # # # # # # # #     # # # # # # # #   # # #   # # # #   #
# # # ######### # # # # # ### # # ### # # # # # ### # # # ### # # ### # # # # # #
# # # #         # # # # # # # # # # # # # # # # # # # # #     # # # # # # # # # #
# # # ########### # # # # # # # # # # # # ##### # # # # ### ##### # # # # # # # #
#   # #           # # # # # # # # # # # #       # # # #   #   #   # # # # # # # #
# # # ########### # # ### # # # # # # # # ####### # # # # # # ##### # # # # # # #
# # #           # # # # #   # # # # # # #         # # # # # # # # # # # # # # # #
# # ########### # # # # # ### # # # # # ########### # # # # # # # # # # # # # # #
# #             # # # # # # # # # # # #             # # # # # #   # # # # # # # #
# # ######### # # # # # # # # # # # ################# # # # # # # # # # # # # # #
# # #       # # # # # # # # # # # # #             #     #   # # # # # # # # # # #
# # # ##### # ### # # # # # # # # # # ################### # # # # # # # # # # # #
# # # #   # # # # # # # # # # # # # #                     # # # # #   # # # # # #
# # # # # ### # # # # # # # # # # # ######################### # # # # # # # # # #
# # # # # # # # # # # # # # # # # #                           # # # # # # # # # #
# # # # ### # # # # # # # # # # # ############################# # # # # # # # # #
# # # #       # # # # # # # # # #                         #     # # # # # # # # #
# # # ####### # # # # # # # # # ################################# # # # # # # # #
# # #           #   # # # # # #                                   # # # # # # # #
# # ############# # # # # # # ##################################### # # # # # # #
# #   # #         # # # # # #                               #       # # # # # # #
# # # # ### # # # # # # # # ######################################### # # # # # #
# # #     # # # # # # # # #                                             # # # # #
# # # ### ### # # # # # # ##################### ######################### # # # #
# # #   # #   # # # # # #     #                                           # # # #
# ##### ####### # # # # ### ####################################### ######### # #
# #             # # # #                             #             #         # # #
# ############# # # # ############### ########################### ########### # #
# #             # # #                                                       # # #
# ########################################################### ######### ####### #
#                                                         #   #                 #
##################################################################### ###########

