######################### #######################################################
# # #   #                                                                       #
# # # ################################################### #######################
# # # #                   #           #               #                         #
# # # # ################# ######### ######### ################################# #
# # # # #               #                       #                               #
# # # # # ############################### ################# ################# # #
# # #   # #             #                                                   # # #
# # # # # ############# # ############################# ##################### # #
# # # #         #     # # #         #                 #                     # # #
# # # ############# # # # # # ################# ########################### # # #
# # # #           # # # # # # #                                 #         # # # #
# # # ########### # # # # # # # ##### ####################### ### ####### # # # #
# # # #         # # # # # # # # # # # #                     #   # #     # # # # #
# # # ######### # # # # # # # # # # # # ################### # # # # # # # # # # #
# # #         # # # # # # # # # # # # # #                 # # # # # # # # # # # #
# # ######### # # # # # # # # # # # # # # ############### # # # # ### # # # # # #
# #         # # # # # # # # # # # # # # # #             # # # # #     # #   # # #
# ######### # # # # # # # # # # # # # # # # ########### # # # # ####### # # # # #
#           # # # # # # # # # # # # # # # # #         # # # # #         # # # # #
# ######### # # # # # # # # # # # # # # # # # ####### # # # # ##### ####### # # #
# # #     # # # # # # # # # # # # # # # # # #       # # # # # #           # # # #
# # ##### # # # # # # # # # # # # # # # # # # ### # # ### # # ############# # # #
# # #   # # # # # # # # # # # # # # # # # # #   # # # # # # # #             # # #
# # # # # # # # # # # # # # # # # # # # # # ##### # # # # ### ######### ### # # #
# # # #   # # # # # # # # # # # # # # # # #       # # # # # #   #       #   # # #
# # # ##### # # # # # # ### # # # # # # # ######### # # # # # ### # ####### # # #
# # #         # # # # # # # # # # # # # #           # # # # # #   # #     # # # #
# # ########### # # # # # # # # # # # # ############# # # # # # # # # # # # # # #
# #             # # # # # # # # # # # #               # # # # # # # # # # # # # #
# # ############# # # # # # # # # # # ##### ########### # # # ##### # # # # # # #
# #               # # #   # # # # # #                   # # # #   # # # #   # # #
# ##### ########### # ### # # # # # ################### # # # # # # # # # # # # #
#                   #   # # # # # #                     # # #   # # # # # # # # #
# ####### ############# # ### # # ####################### # ### # # # # ### # # #
# #     #             #   # # # #   #                 #     #   # # # #   # # # #
# # ################# # # # # # # # # ##### ################### # # # ##### # # #
# # #               # # # # # # # #   #     #                 # # # #   # # # # #
# # # ############# ### # # # # # # # # ### # ############### # # # ##### # # # #
# # # #     #     # # # # # # # # # # # # # # #               # # # #     # # # #
# # # # ### ##### # # # # # # # ### # # # # # ############### # # # # # ### # # #
# # # # #     # # # #   # # # # #   # #   # # # #           # # # # # #   # # # #
# # # # # ##### # # # # # # # # ##### ##### # # # ######### # # # # # # ### # # #
#   # # # #   # # # # # # # # # #         # # # # #         # # # # # #     # # #
# # # ### ### # # # ### # # # # ########### # # # # # ##### # # # # ####### # # #
# # # #       # # # # # # # # #             # # # # # #     # # # # #       # # #
# # # # ####### # # # # ### # ############### # # # # # ### # # # # ####### # # #
# # #           # # # # # # #                 # # # # # #   # # # #       # # # #
# # ############# # # # # # ######### ######### # # # # ##### # # # ##### # # # #
# #               # # # # #                       # # # #     # # #     # # # # #
# ############### # # # # ############################# ####### # ### ### ### # #
#             #   # # # #                                       #   #   # # # # #
# # ############### # # ######################################### ######### # # #
# #               # # #                             #                   #     # #
# ################# # ######################################################### #
#                                                       #                       #
######################################### #######################################

