############# ###################################################################
#                                                                             # #
# ########################################################################### # #
# #                           #                           #   #         # # #   #
# # # # # ##################### ############################# # ####### # # ### #
# # # # # # #                 # #                           # # #     #   # # # #
# # ### # # ################# # # ######################### # # # # # # ### # # #
#   # # # # #         #     # #   #                       # # #   # # #   # #   #
# # # # # # # ######### # # # # # # ##################### # # ##### # ### # # # #
# # # # # # #         # # #   # # # #                   # #         # # # # # # #
# # # # # # # ####### ### # # # # # ############### ### # ######### # # # # # # #
# # # # # # # #     # #   # # # # # #             #   # #           # #   # # # #
# ### # ### # # ### # # # # # # # # ############# # # # ############# # # # ### #
# # # # # # # # # # # # # # # # # # #       #   # # # #               # #   # # #
# # # # # # # # # # # # # # # # # # # ####### ### ### ############### # # # # # #
# # # # # #   #   # # # # # # # # # # #         # #         #         # # # # # #
# # # # # # # ### # # # # # # # # # # # ####### # ################### ##### # # #
# # # #   # #     # # # # # # # # # # # #     # #                     # # # # # #
# # # # ######### # # # # # # # # # # # # ### # ####################### # # # # #
# # # # # #       # # # # # # # # # # # #   #                             # # # #
# # # # # ######### # # # # # # # # # # ### # ############################# # # #
# # #               # # # # # # # # # #   # # #                           # # # #
# # ################# # # ### # # # # ####### # ############################# # #
# #                   # # # # # # #           # #                         # # # #
# # ################### ### # # # # ####### # # # # ####################### # # #
# # #                   # # # # # # #   #   # # # #               #       # # # #
# # # # ################# # # # # # # # # # # # # # ##################### # # # #
# # # #                   # # # # # # # # # # # # # #                       # # #
# # # # ################### # # # # ### ##### # ### # ####################### # #
# #   # #               #   # # # # # # #     # #   # #                     # # #
# ########### ############# # # ### # # # ### # # # # # ################### # # #
# #         #   # #         # # # # # # # # # # # # # # #                 # # # #
# # ####### # ### # ######### # # # # # # # # # # # # # # ############### # # # #
# # #     # #   # #           # # # #   #   # # # # # # #           #   # # # # #
# # # ### # # ### ########### # # # # # ##### # # # # # # ############# # # # # #
# # #   # # #                 # # # # #       # # # # # #             # # # # # #
# # # # # ######### ######### # # # ### # # # # # # # # # ### ####### # # # # # #
# #   # #         # #         # #   # # # # # # # # # # # #     # #   # # # # # #
# ##### ######### ############# # # # ##### ### # # # # # # ### # # # # # # # # #
# # # #         #     #         # # # #       # # # # # # #   # # # # # # # # # #
# # # # ####### ##### # ############# ##### # # ### # # # ##### # # # # # # # # #
# # # # #     #     # #   #       # # # #   # # # # # # #     # # # # # # # # # #
# # # # # ### ##### ##### # ##### # # # # ### # # # # # ######### # # # # # # # #
# # # # # # #     # # #   # #     # # # #   # # #   # #           # #   # # # # #
# # # # # # ### # # # ##### # ##### # # ### # # # # # ########### # # # # # # # #
# # # # #     # # # # #     # #     # # #   # # # # #             # # # # # # # #
# # # # ##### # ### # # ##### # ##### # # ### # # # ############# # ### # ### # #
#   # #       # # # # # #     # #     #     # #   #               # # # # # # # #
# # # ####### # # # # # # ##### ##### ##### # # # ################# # # # # # # #
# # #         # # # # # #       #     #     # # #                   # # # # # # #
# # ######### # # ### # ######### ##### ##### ##################### # # ### # # #
# # #         # # # #                   #                             #     # # #
# ############# # # ### ##################################################### # #
#               # #                                                           # #
########### ##### ####################################### ##################### #
#                                     #                                         #
####################### #########################################################

