############################# ###################################################
#                                                                               #
# ######### ######################### # #########################################
# #         #                       # # #                 #                     #
# # ##### # # ##################### # # # ##################################### #
# # #   # # # #                   # # # # #                                   # #
# # # ##### # # ################# # # # # # ################################# # #
# # #     # # # #               # # # # # # #                               # # #
# # ##### # # # # # # ######### # # # # # # # ########### ################### # #
# # #     # # # # # # #       # # # # # # # # #                             # # #
# # ### # # # # # # # # ##### # # # # # # # # # ############################# # #
# # # # # # # # # # # # #   # # # # # # # # # # #       #                   # # #
# # # # # # # # # # # # # # # # # # # # # # # # ### ############### ### ### # # #
# # #   # # # # # # # # # #   # # # # # # # # # #     #           # # #   # # # #
# # # ### ### # # # # # ##### # # # # # # # # # ##### # ######### # # ### ### # #
# # # # # # # # # # # # #       # # # # # # # # #               # # # # # # # # #
# # # # # # # # # # # ### ####### # # # # # # # ############### # # # # ### # # #
# # # # # # # # # # # # #         # # # # # # # #         #   # # # # #   # # # #
# # # # # # # # # # # # ### ####### # # # # # # # # ######### ### # # # # # # # #
# # # # # # # # # # # #     #       # # # # # # # #         # # # # # # # # # # #
# # # # ### # # # # # ############### # # # # # # # ####### # # # # # # # # # # #
# # # # # # # # # # #                 # # # # # # # #     # # # # # # # # # # # #
# # # # # # # # # # ################# ### # ### # # # ### # # # # # # ### # # # #
# # # # # # #   # #                 #   # # # # # # # #     # # # # # #   # #   #
# # # # # # # # # ####################### # # # # # # ####### # # # # # # # # # #
# # # # # # # # #                           # # # # #   #         # # # # # # # #
# ### # # # ### # ########################### # # # ############# # # # # # # # #
# # # # # # # # #                             # # #                 # # # # # # #
### # # # # # # ############################### # ################### # # # # # #
# # # #   # # #                                 #                     # # # # # #
# # # # ### # ################################### ##################### # # # # #
# # # # # # #                                             #       #     # # # # #
# # # # # # ### # # # ############################### ##### # ########### # # # #
# # # #   #     # # # #       #                     # #     #             # # # #
# # # ### ##### # # # # # ############### ########### ##### # ########### # # # #
# #           # # # # # #                             #     #           # # # # #
# ########### # # # # # ### ##################### # ######### ########### # # # #
#   #       # # # # # #   # #         #         # #           # #         # # # #
# ######### # # # # # ### ### # ############### ########### # # # ######### # # #
# #   #     # # # # # #   # # #               #           # # # # #     # # # # #
# # ##### # # ### # # # # # # # # ########### ########### # # # # # ### # # # # #
# # #   # # # # # # # # # # # # # #         # #         # # # # # # # # # # # # #
# # # ### # # # # # # # # # # # # # # ##### # # ####### # # # # # # # # # # # # #
# # #     # # # # # # # #   # # # # # #   # # # #     # # # # # # # #   # # # # #
# # ####### # # # # # ######### # # # # # ### # # ### ### # # # # # # ### # # # #
# #             # # #   #       # # # # #   # # # # # # # # #   #   #     # # # #
# ### ########### # # ########### # # # ##### # # # # # # # ##### # # ##### # # #
#           #     # #   #   #     # # #       # # #     # #   #   # #     # # # #
# ##### ########### ####### ### ### ########### # ####### ######### ####### # # #
# #                                 #                       #             # # # #
# # ################################### ################################### # # #
# #                                                     #                   # # #
# # ############################################################### ######### # #
# #                                                                           # #
# ################################################### ######################### #
#                                   #                       #                   #
################################### #############################################

